locus_tag,old_locus_tag,start,end,Product,Length
SARO_RS00005,Saro_0001,18,1520,chromosomal replication initiator protein DnaA,1502
SARO_RS00010,Saro_0002,1629,2423,HesA/MoeB/ThiF family protein,794
SARO_RS00015,Saro_0003,2412,3122,NAD-dependent deacylase,710
SARO_RS00020,Saro_0004,3158,3886,4-hydroxy-tetrahydrodipicolinate reductase,728
SARO_RS00025,Saro_0005,3946,5124,hypothetical protein,1178
SARO_RS00030,Saro_0006,5121,5816,endonuclease III,695
SARO_RS00035,Saro_0007,5813,6211,hypothetical protein,398
SARO_RS00040,Saro_0008,6244,7563,dicarboxylate/amino acid:cation symporter,1319
SARO_RS00045,Saro_0009,7692,8762,chorismate synthase,1070
SARO_RS00050,Saro_0010,8836,9147,antibiotic biosynthesis monooxygenase,311
SARO_RS00055,Saro_0011,9144,9491,arsenate reductase,347
SARO_RS00060,Saro_0012,9493,10056,nicotinamide riboside transporter PnuC,563
SARO_RS00065,Saro_0013,10050,10571,N-acetylglucosamine-6-phosphate deacetylase,521
SARO_RS00070,Saro_0014,10639,11079,biopolymer transporter ExbD,440
SARO_RS00075,Saro_0015,11122,11652,biopolymer transporter ExbD,530
SARO_RS00080,Saro_0016,11772,12521,MotA/TolQ/ExbB proton channel family protein,749
SARO_RS00085,Saro_0017,12595,13257,energy transducer TonB,662
SARO_RS00090,Saro_0018,13602,14504,hypothetical protein,902
SARO_RS00095,Saro_0019,14577,15884,homoserine dehydrogenase,1307
SARO_RS00100,NA,15903,16343,hypothetical protein,440
SARO_RS00105,Saro_0021,16582,17574,fructose-bisphosphatase class II,992
SARO_RS00110,Saro_0022,17872,19323,hypothetical protein,1451
SARO_RS00115,Saro_0023,19422,23705,DNA-directed RNA polymerase subunit beta',4283
SARO_RS00120,Saro_0024,23796,27974,DNA-directed RNA polymerase subunit beta,4178
SARO_RS20050,NA,28348,28623,hypothetical protein,275
SARO_RS00130,NA,28829,29299,hypothetical protein,470
SARO_RS00135,Saro_0027,29541,30233,DUF2975 domain-containing protein,692
SARO_RS00140,Saro_0028,30233,30454,transcriptional regulator,221
SARO_RS00145,Saro_0029,30749,31261,50S ribosomal protein L10,512
SARO_RS00150,Saro_0030,31331,31702,50S ribosomal protein L7/L12,371
SARO_RS00155,Saro_0031,31788,33140,sensor histidine kinase,1352
SARO_RS20435,Saro_0032,33228,33710,cytochrome c%2C class I,482
SARO_RS00165,Saro_0033,33846,35222,MATE family efflux transporter,1376
SARO_RS00170,Saro_0034,35373,35660,molecular chaperone GroES,287
SARO_RS00175,Saro_0035,35710,37353,molecular chaperone GroEL,1643
SARO_RS00180,Saro_0036,37600,39198,hybrid sensor histidine kinase/response regulator,1598
SARO_RS00185,Saro_0037,39195,39650,N-acetyltransferase,455
SARO_RS00190,Saro_0038,39737,40942,DUF445 domain-containing protein,1205
SARO_RS00195,Saro_0039,41050,44232,AcrB/AcrD/AcrF family protein,3182
SARO_RS00200,Saro_0040,44243,45412,efflux RND transporter periplasmic adaptor subunit,1169
SARO_RS00205,Saro_0041,45711,46010,DUF1153 domain-containing protein,299
SARO_RS00210,Saro_0042,46025,46357,hypothetical protein,332
SARO_RS00215,Saro_0043,46499,47653,tRNA 2-thiouridine(34) synthase MnmA,1154
SARO_RS00220,NA,47669,47941,hypothetical protein,272
SARO_RS00225,Saro_0045,48057,49208,serine hydrolase,1151
SARO_RS00230,Saro_0046,49205,50020,PhzF family phenazine biosynthesis protein,815
SARO_RS00235,Saro_0047,50017,50994,iron transporter,977
SARO_RS00240,Saro_0048,51006,51617,pyridoxine/pyridoxamine 5'-phosphate oxidase,611
SARO_RS00245,Saro_0049,51839,52816,molecular chaperone DnaJ,977
SARO_RS00250,Saro_0050,52820,53854,YihY/virulence factor BrkB family protein,1034
SARO_RS00255,Saro_0051,53851,54654,enoyl-[acyl-carrier-protein] reductase FabI,803
SARO_RS00260,Saro_0052,54739,55320,hypothetical protein,581
SARO_RS00265,Saro_0053,55425,55937,ubiquinone biosynthesis protein UbiB,512
SARO_RS00270,Saro_0054,55939,56421,disulfide bond formation protein B,482
SARO_RS00275,Saro_0055,56435,57826,S41 family peptidase,1391
SARO_RS00280,Saro_0056,57928,59172,peptidase M23,1244
SARO_RS00285,Saro_0057,59181,59606,23S rRNA (pseudouridine(1915)-N(3))-methyltransferase RlmH,425
SARO_RS00290,Saro_0058,59701,60093,ribosome silencing factor,392
SARO_RS00295,Saro_0059,60203,60889,nicotinate-nucleotide adenylyltransferase,686
SARO_RS00300,Saro_0060,60853,62130,gamma-glutamyl-phosphate reductase,1277
SARO_RS00305,Saro_0061,62365,63528,M23 family peptidase,1163
SARO_RS00310,Saro_0062,63536,63886,polymer-forming cytoskeletal protein,350
SARO_RS00315,Saro_0063,64024,64728,DUF1013 domain-containing protein,704
SARO_RS00320,Saro_0064,64795,65796,NAD(P)H quinone oxidoreductase,1001
SARO_RS00325,NA,65889,66119,DUF1192 domain-containing protein,230
SARO_RS00330,Saro_0066,66339,68717,ATP-dependent Clp protease ATP-binding subunit ClpA,2378
SARO_RS00335,Saro_0067,68843,69850,DNA ligase-associated DEXH box helicase,1007
SARO_RS00340,Saro_0068,69911,71506,ATP-dependent DNA ligase,1595
SARO_RS00345,NA,71562,71750,hypothetical protein,188
SARO_RS00350,Saro_0069,71824,72219,globin,395
SARO_RS00355,Saro_0070,72269,72907,DUF1275 domain-containing protein,638
SARO_RS00360,Saro_0071,72885,73172,DUF167 domain-containing protein,287
SARO_RS00365,Saro_0072,73153,73716,gamma carbonic anhydrase family protein,563
SARO_RS00370,Saro_0073,73731,74723,porphobilinogen synthase,992
SARO_RS00375,Saro_0074,74760,76301,M23 family peptidase,1541
SARO_RS00380,Saro_0075,76481,77512,DUF3667 domain-containing protein,1031
SARO_RS00385,Saro_0076,77647,79581,ATP-dependent metallopeptidase FtsH/Yme1/Tma family protein,1934
SARO_RS00390,Saro_0077,79691,80671,tRNA(Ile)-lysidine synthetase,980
SARO_RS00395,Saro_0078,80685,81668,hypothetical protein,983
SARO_RS00400,Saro_0079,81777,82823,DUF4115 domain-containing protein,1046
SARO_RS00405,Saro_0080,82906,85185,phosphoenolpyruvate--protein phosphotransferase,2279
SARO_RS20440,Saro_0081,85389,85547,DUF465 domain-containing protein,158
SARO_RS00410,Saro_0082,85777,85974,DUF465 domain-containing protein,197
SARO_RS00415,Saro_0083,86111,86605,DUF1465 domain-containing protein,494
SARO_RS00420,Saro_0084,86610,88079,glycerol kinase,1469
SARO_RS00425,Saro_0085,88076,89545,glycerol-3-phosphate dehydrogenase,1469
SARO_RS00430,Saro_0086,89620,90519,MBL fold hydrolase,899
SARO_RS00435,Saro_0087,90501,91166,DUF4230 domain-containing protein,665
SARO_RS00440,Saro_0088,91248,91976,hypothetical protein,728
SARO_RS00445,Saro_0089,92038,93036,quinolinate synthase NadA,998
SARO_RS00450,Saro_0090,93172,94065,EamA/RhaT family transporter,893
SARO_RS00455,Saro_0091,94149,95252,alkene reductase,1103
SARO_RS00460,Saro_0092,95267,96148,CoA ester lyase,881
SARO_RS00465,Saro_0093,96131,96439,hypothetical protein,308
SARO_RS00470,Saro_0094,96436,97104,lipoate-protein ligase B,668
SARO_RS00475,Saro_0095,97182,98003,hypothetical protein,821
SARO_RS00480,Saro_0096,98012,98638,methyltransferase domain-containing protein,626
SARO_RS00485,Saro_0097,98805,100091,MFS transporter,1286
SARO_RS00490,Saro_0098,100159,101661,hypothetical protein,1502
SARO_RS00495,Saro_0099,101654,102610,CDP-alcohol phosphatidyltransferase,956
SARO_RS00500,Saro_0100,102849,103934,CDP-alcohol phosphatidyltransferase,1085
SARO_RS00505,Saro_0101,104030,105130,inositol-3-phosphate synthase,1100
SARO_RS00510,Saro_0102,105225,105974,nucleotidyltransferase,749
SARO_RS00515,Saro_0103,106017,106511,DUF2141 domain-containing protein,494
SARO_RS00520,Saro_0104,106888,107547,ribulose-phosphate 3-epimerase,659
SARO_RS00525,Saro_0105,107549,109435,heparinase,1886
SARO_RS00530,Saro_0106,109446,111035,bifunctional phosphoribosylaminoimidazolecarboxamide formyltransferase/IMP cyclohydrolase PurH,1589
SARO_RS00535,Saro_0107,111134,112870,CBS domain-containing protein,1736
SARO_RS00540,Saro_0108,112945,113574,cell wall hydrolase,629
SARO_RS00545,Saro_0109,113790,114131,DUF1491 domain-containing protein,341
SARO_RS00550,Saro_0110,114133,114615,PaaI family thioesterase,482
SARO_RS00555,Saro_0111,114602,115063,PTS IIA-like nitrogen-regulatory protein PtsN,461
SARO_RS00560,Saro_0112,115237,115818,ribosomal subunit interface protein,581
SARO_RS00565,Saro_0113,115877,116566,DNA polymerase III subunit epsilon,689
SARO_RS00570,Saro_0114,116615,117220,dephospho-CoA kinase,605
SARO_RS00575,Saro_0115,117217,118089,shikimate dehydrogenase,872
SARO_RS00580,Saro_0116,118086,118673,maf-like protein,587
SARO_RS00585,Saro_0117,118670,119512,phosphoenolpyruvate synthase regulatory protein,842
SARO_RS00590,Saro_0118,119850,120875,uroporphyrinogen decarboxylase,1025
SARO_RS00595,Saro_0119,120955,121398,CopD family protein,443
SARO_RS00600,Saro_0120,121800,123056,transcription termination factor Rho,1256
SARO_RS00605,Saro_0121,123162,125729,ATP-dependent helicase,2567
SARO_RS20445,Saro_0122,125747,126037,RNA-binding S4 domain-containing protein,290
SARO_RS00610,Saro_0123,126051,126389,ferredoxin family protein,338
SARO_RS00615,Saro_0124,126726,127250,CarD family transcriptional regulator,524
SARO_RS00620,Saro_0125,127480,128208,DUF2807 domain-containing protein,728
SARO_RS00625,Saro_0126,128212,129159,threonylcarbamoyl-AMP synthase,947
SARO_RS00630,Saro_0127,129220,130938,acyl-CoA dehydrogenase,1718
SARO_RS00635,Saro_0128,130935,131750,DUF815 domain-containing protein,815
SARO_RS00640,Saro_0129,131784,133289,sorbosone dehydrogenase,1505
SARO_RS00645,Saro_0130,133354,133836,GAF domain-containing protein,482
SARO_RS00650,NA,133981,134679,glycine zipper 2TM domain-containing protein,698
SARO_RS00655,Saro_0132,134788,135942,acyl-CoA dehydrogenase,1154
SARO_RS00660,Saro_0133,136094,137041,chromosome partitioning protein ParB,947
SARO_RS00665,Saro_0134,137038,137814,ParA family protein,776
SARO_RS00670,Saro_0135,137811,138503,ribosomal RNA small subunit methyltransferase G,692
SARO_RS00675,Saro_0136,138500,140359,tRNA uridine-5-carboxymethylaminomethyl(34) synthesis enzyme MnmG,1859
SARO_RS00680,Saro_0137,140445,141758,tRNA uridine-5-carboxymethylaminomethyl(34) synthesis GTPase MnmE,1313
SARO_RS00685,Saro_0138,141791,142051,hypothetical protein,260
SARO_RS00690,Saro_0139,142162,142860,dienelactone hydrolase family protein,698
SARO_RS00695,Saro_0140,142959,143342,nuclear transport factor 2 family protein,383
SARO_RS00700,Saro_0141,143400,143744,DNA-directed RNA polymerase subunit omega,344
SARO_RS00705,Saro_0142,143844,145358,replicative DNA helicase,1514
SARO_RS00710,Saro_0143,145505,145999,UPF0262 family protein,494
SARO_RS00715,Saro_0144,146028,146723,lysozyme,695
SARO_RS00720,Saro_0145,146720,147157,cytidine deaminase,437
SARO_RS00725,Saro_0146,147206,147760,deoxycytidine triphosphate deaminase,554
SARO_RS00730,Saro_0147,147894,149066,saccharopine dehydrogenase,1172
SARO_RS00735,Saro_0148,149157,149603,bacitracin resistance protein BacA,446
SARO_RS00740,Saro_0149,149684,150133,hypothetical protein,449
SARO_RS00745,Saro_0150,150130,150531,hypothetical protein,401
SARO_RS00750,Saro_0151,150718,151713,adenosine kinase,995
SARO_RS00755,Saro_0152,151725,153050,Xaa-Pro aminopeptidase,1325
SARO_RS00760,Saro_0153,153225,153653,CBS domain-containing protein,428
SARO_RS00765,Saro_0154,153797,154090,hypothetical protein,293
SARO_RS00770,Saro_0155,154122,154466,iron-sulfur cluster assembly accessory protein,344
SARO_RS00775,Saro_0156,154525,155304,exodeoxyribonuclease III,779
SARO_RS00780,Saro_0158,155613,156290,peptide-methionine (S)-S-oxide reductase,677
SARO_RS00785,Saro_0159,156327,156797,transcriptional repressor,470
SARO_RS00790,Saro_0160,156827,158104,MFS transporter,1277
SARO_RS00795,Saro_0161,158147,160069,1-deoxy-D-xylulose-5-phosphate synthase,1922
SARO_RS00800,Saro_0162,160099,160794,hypothetical protein,695
SARO_RS00805,Saro_0163,160892,163015,amino acid transporter,2123
SARO_RS00810,Saro_0164,163049,163438,GntR family transcriptional regulator,389
SARO_RS00815,Saro_0165,163591,163872,integration host factor subunit beta,281
SARO_RS00825,Saro_0166,164436,165092,PilZ domain-containing protein,656
SARO_RS00830,Saro_0167,165119,166585,sulfotransferase family protein,1466
SARO_RS00835,Saro_0168,166719,169919,TonB-dependent receptor,3200
SARO_RS00840,Saro_0169,170278,171132,M23 family peptidase,854
SARO_RS00845,Saro_0170,171151,171354,DUF2093 domain-containing protein,203
SARO_RS00850,Saro_0171,171381,172862,exodeoxyribonuclease VII large subunit,1481
SARO_RS00855,Saro_0172,172861,174150,phosphoribosylamine--glycine ligase,1289
SARO_RS00860,Saro_0173,174140,174769,isochorismatase,629
SARO_RS00865,Saro_0174,174769,175971,CoA transferase,1202
SARO_RS00870,Saro_0175,175968,177854,5-oxoprolinase,1886
SARO_RS00875,Saro_0176,177868,179916,hydantoinase/oxoprolinase family protein,2048
SARO_RS00880,Saro_0177,179921,180835,hydroxymethylglutaryl-CoA lyase,914
SARO_RS00885,Saro_0178,181101,183626,TonB-dependent receptor,2525
SARO_RS00890,Saro_0179,183684,184328,GntR family transcriptional regulator,644
SARO_RS00895,Saro_0180,184339,184839,hemerythrin,500
SARO_RS00900,Saro_0181,184954,185745,histidine phosphatase family protein,791
SARO_RS00905,Saro_0182,185738,186619,NAD(P)H-hydrate dehydratase,881
SARO_RS00910,Saro_0183,186588,186974,ferredoxin,386
SARO_RS00915,Saro_0184,186971,189067,S9 family peptidase,2096
SARO_RS00920,Saro_0185,189125,189562,DUF2497 domain-containing protein,437
SARO_RS00925,Saro_0186,189604,191061,membrane protein,1457
SARO_RS00930,Saro_0187,191067,191660,protein-L-isoaspartate O-methyltransferase,593
SARO_RS00935,Saro_0188,191828,193351,fumarate hydratase,1523
SARO_RS00945,NA,194480,195367,hypothetical protein,887
SARO_RS00950,Saro_0190,195378,196112,DNA-binding response regulator,734
SARO_RS00955,Saro_0191,196166,197983,long-chain fatty acid--CoA ligase,1817
SARO_RS00960,Saro_0192,198104,199855,gamma-glutamyltransferase,1751
SARO_RS00965,Saro_0193,199866,200915,dihydroorotate dehydrogenase (quinone),1049
SARO_RS00970,Saro_0194,201349,201789,SUF system Fe-S cluster assembly regulator,440
SARO_RS00975,Saro_0195,201786,203267,Fe-S cluster assembly protein SufB,1481
SARO_RS00980,Saro_0196,203407,203928,endonuclease domain-containing protein,521
SARO_RS00985,Saro_0197,203940,204683,Fe-S cluster assembly ATPase SufC,743
SARO_RS00990,Saro_0198,204680,205414,SufBD,734
SARO_RS00995,Saro_0199,205411,206622,cysteine desulfurase,1211
SARO_RS01000,Saro_0200,206619,207101,SUF system Fe-S cluster assembly protein,482
SARO_RS01005,Saro_0201,207125,207487,iron-sulfur cluster assembly accessory protein,362
SARO_RS01015,Saro_0203,208948,209634,sulfite exporter TauE/SafE family protein,686
SARO_RS01020,Saro_0204,209688,211682,threonine--tRNA ligase,1994
SARO_RS01025,Saro_0205,212005,212925,KR domain-containing protein,920
SARO_RS01030,Saro_0206,213013,213429,hypothetical protein,416
SARO_RS01035,Saro_0207,213426,213617,transcriptional regulator,191
SARO_RS01040,Saro_0208,213651,214397,alpha/beta hydrolase,746
SARO_RS01045,Saro_0209,214390,215325,hypothetical protein,935
SARO_RS01050,Saro_0210,215322,216314,LLM class flavin-dependent oxidoreductase,992
SARO_RS01055,Saro_0211,216557,221278,glutamate dehydrogenase,4721
SARO_RS01060,Saro_0212,221359,222126,molybdate ABC transporter substrate-binding protein,767
SARO_RS01065,Saro_0213,222107,222826,molybdate ABC transporter permease subunit,719
SARO_RS01070,Saro_0214,222816,223424,molybdate ABC transporter ATP-binding protein,608
SARO_RS01075,Saro_0215,223426,224685,6-aminohexanoate-dimer hydrolase,1259
SARO_RS01080,Saro_0216,224840,226087,pyridine nucleotide-disulfide oxidoreductase,1247
SARO_RS01085,Saro_0217,226099,227148,tRNA epoxyqueuosine(34) reductase QueG,1049
SARO_RS01090,Saro_0218,227195,228184,ABC transporter ATP-binding protein,989
SARO_RS01095,Saro_0219,228181,229425,ABC transporter permease,1244
SARO_RS01100,Saro_0220,229503,230840,cytochrome P450,1337
SARO_RS01105,Saro_0221,230975,231466,peptide-methionine (R)-S-oxide reductase,491
SARO_RS01110,Saro_0222,231568,231852,50S ribosomal protein L28,284
SARO_RS01115,Saro_0223,231976,232431,nucleoside deaminase,455
SARO_RS01120,Saro_0224,232442,233143,ribonuclease T(2),701
SARO_RS01125,Saro_0225,233145,233567,hypothetical protein,422
SARO_RS01130,Saro_0226,233605,234471,nicotinate-nucleotide diphosphorylase (carboxylating),866
SARO_RS01135,Saro_0227,234587,235384,DNA-binding response regulator,797
SARO_RS01140,Saro_0228,235497,236642,sensor histidine kinase,1145
SARO_RS01145,Saro_0229,236715,237512,DSBA oxidoreductase,797
SARO_RS01150,Saro_0230,237523,238878,peptidase M48,1355
SARO_RS01155,Saro_0231,238919,239863,alpha/beta hydrolase,944
SARO_RS01160,Saro_0232,239934,241280,hypothetical protein,1346
SARO_RS01165,Saro_0233,241371,242273,CoA ester lyase,902
SARO_RS01170,Saro_0234,242270,243529,MFS transporter,1259
SARO_RS01175,Saro_0235,243529,243966,DUF2141 domain-containing protein,437
SARO_RS01180,Saro_0236,243963,244673,sterol desaturase,710
SARO_RS01185,Saro_0237,244870,246366,ATP-dependent helicase,1496
SARO_RS01190,Saro_0238,246695,248005,peptidase M20,1310
SARO_RS20450,Saro_0239,248002,248190,DUF1289 domain-containing protein,188
SARO_RS01195,Saro_0240,248163,249485,hypothetical protein,1322
SARO_RS01200,Saro_0241,249771,250346,UPF0016 domain-containing protein,575
SARO_RS01205,Saro_0242,250407,250910,DNA repair protein MmcB-related protein,503
SARO_RS01210,NA,250928,251362,hypothetical protein,434
SARO_RS01220,Saro_0244,251857,253635,type I secretion system permease/ATPase,1778
SARO_RS01225,Saro_0245,253632,254972,HlyD family type I secretion periplasmic adaptor subunit,1340
SARO_RS01230,Saro_0246,254975,256591,Type I secretion outer membrane protein%2C TolC,1616
SARO_RS01235,Saro_0247,256820,257794,bile acid:sodium symporter,974
SARO_RS01240,Saro_0248,257827,259188,glutamate-1-semialdehyde 2%2C1-aminomutase,1361
SARO_RS01245,Saro_0249,259175,259891,TetR/AcrR family transcriptional regulator,716
SARO_RS01250,Saro_0250,260029,262320,TonB-dependent receptor,2291
SARO_RS01255,Saro_0251,262402,264123,NAD(P)/FAD-dependent oxidoreductase,1721
SARO_RS01260,Saro_0252,264168,265013,oxidoreductase,845
SARO_RS01265,Saro_0253,265107,266273,hypothetical protein,1166
SARO_RS01270,Saro_0254,266331,267662,FAD-dependent oxidoreductase,1331
SARO_RS01275,Saro_0255,268306,269598,DUF4102 domain-containing protein,1292
SARO_RS01280,NA,269700,269858,DNA-binding protein,158
SARO_RS01285,Saro_0257,270703,271512,hypothetical protein,809
SARO_RS01290,Saro_0258,271746,272366,hypothetical protein,620
SARO_RS01295,Saro_0259,272477,273949,hypothetical protein,1472
SARO_RS01300,Saro_0260,274151,276076,DUF262 domain-containing protein,1925
SARO_RS01305,Saro_0261,276073,278802,class I SAM-dependent DNA methyltransferase,2729
SARO_RS01310,Saro_0262,278799,279641,hypothetical protein,842
SARO_RS01315,NA,280220,281029,hypothetical protein,809
SARO_RS01320,Saro_0264,281100,283169,DEAD/DEAH box helicase,2069
SARO_RS01325,Saro_0265,283162,284337,hypothetical protein,1175
SARO_RS01335,Saro_0266,284896,285792,thioredoxin,896
SARO_RS01340,Saro_0267,285798,286427,ATP-dependent protease,629
SARO_RS01345,Saro_0268,286443,287063,MarC family protein,620
SARO_RS01350,Saro_0269,287068,287892,hypothetical protein,824
SARO_RS01355,Saro_0270,287952,288215,hypothetical protein,263
SARO_RS01360,Saro_0271,288402,289457,ribonucleotide-diphosphate reductase subunit beta,1055
SARO_RS01365,Saro_0272,289903,290175,DUF2171 domain-containing protein,272
SARO_RS01370,Saro_0273,290466,290951,PepSY domain-containing protein,485
SARO_RS01375,Saro_0274,291083,293059,ribonucleotide-diphosphate reductase subunit alpha,1976
SARO_RS01380,Saro_0275,293585,293833,GlsB/YeaQ/YmgE family stress response membrane protein,248
SARO_RS01385,Saro_0276,293861,295369,ATP-binding protein,1508
SARO_RS01390,Saro_0277,295554,296258,hypothetical protein,704
SARO_RS01395,Saro_0278,296295,299132,DNA polymerase I,2837
SARO_RS01400,Saro_0279,299427,299615,hypothetical protein,188
SARO_RS01405,Saro_0280,299871,300932,serine hydrolase,1061
SARO_RS01410,Saro_0281,301057,302388,phosphotransferase family protein,1331
SARO_RS01415,Saro_0282,302388,303689,acyl-CoA dehydrogenase,1301
SARO_RS01420,Saro_0283,303724,304332,hypothetical protein,608
SARO_RS01425,Saro_0284,304519,305724,S-adenosylmethionine synthase,1205
SARO_RS01430,Saro_0285,305765,307333,apolipoprotein N-acyltransferase,1568
SARO_RS01435,Saro_0286,307416,308330,DUF4167 domain-containing protein,914
SARO_RS01440,Saro_0287,308535,309401,peptide chain release factor N(5)-glutamine methyltransferase,866
SARO_RS01445,Saro_0288,309482,310546,peptide chain release factor 1,1064
SARO_RS01450,Saro_0289,310668,311927,histidine--tRNA ligase,1259
SARO_RS01455,Saro_0290,312028,313980,peptidase,1952
SARO_RS01460,Saro_0291,313874,314635,DUF1345 domain-containing protein,761
SARO_RS01465,Saro_0292,314790,315329,inorganic diphosphatase,539
SARO_RS01470,Saro_0293,315351,316694,BON domain-containing protein,1343
SARO_RS01475,Saro_0294,316744,318090,TldD/PmbA family protein,1346
SARO_RS01480,Saro_0295,318152,318571,hypothetical protein,419
SARO_RS01485,Saro_0296,318728,319504,LPS export ABC transporter ATP-binding protein,776
SARO_RS01490,Saro_0297,319545,321041,RNA polymerase sigma-54 factor,1496
SARO_RS01495,Saro_0298,321137,322000,phosphodiesterase,863
SARO_RS01500,Saro_0299,322022,323905,hypothetical protein,1883
SARO_RS01505,Saro_0300,323913,324809,hypothetical protein,896
SARO_RS01510,Saro_0301,324814,327390,4Fe-4S dicluster domain-containing protein,2576
SARO_RS01515,Saro_0302,327631,328644,tetratricopeptide repeat protein,1013
SARO_RS01520,Saro_0303,328963,329664,DNA-binding response regulator,701
SARO_RS20060,Saro_0304,329740,330558,LuxR family transcriptional regulator,818
SARO_RS01530,Saro_0305,330670,331386,tRNA (guanosine(46)-N7)-methyltransferase TrmB,716
SARO_RS01535,Saro_0306,331516,332769,DUF4102 domain-containing protein,1253
SARO_RS01540,Saro_0307,333031,333927,LysR family transcriptional regulator,896
SARO_RS01545,Saro_0308,333915,334139,DUF2274 domain-containing protein,224
SARO_RS01550,Saro_0309,334136,335332,conjugal transfer protein TraI,1196
SARO_RS01555,Saro_0310,335329,336360,P-type conjugative transfer protein TrbG,1031
SARO_RS01560,Saro_0311,336357,337040,conjugal transfer protein TrbF,683
SARO_RS01565,Saro_0312,337044,338354,P-type conjugative transfer protein TrbL,1310
SARO_RS01570,NA,338356,338676,hypothetical protein,320
SARO_RS01575,Saro_0314,338682,339458,P-type conjugative transfer protein TrbJ,776
SARO_RS01580,Saro_0315,339464,341929,conjugal transfer protein TrbE,2465
SARO_RS01585,Saro_0316,341936,342211,conjugal transfer protein,275
SARO_RS01590,Saro_0317,342211,342549,conjugal transfer protein TrbC,338
SARO_RS01595,Saro_0318,342540,343523,P-type conjugative transfer ATPase TrbB,983
SARO_RS01600,Saro_0319,343777,344160,hypothetical protein,383
SARO_RS01605,Saro_0320,344157,346142,conjugal transfer protein TraG,1985
SARO_RS01610,Saro_0321,346387,346593,hypothetical protein,206
SARO_RS01615,Saro_0322,347120,347647,bifunctional adenosylcobinamide kinase/adenosylcobinamide-phosphate guanylyltransferase,527
SARO_RS01620,Saro_0323,347644,349131,cobyric acid synthase,1487
SARO_RS01625,Saro_0324,349119,350069,cobalamin biosynthesis protein CobD,950
SARO_RS01630,Saro_0325,350062,351045,threonine-phosphate decarboxylase,983
SARO_RS01635,Saro_0326,351042,351782,adenosylcobinamide-GDP ribazoletransferase,740
SARO_RS01640,Saro_0327,351779,352348,phosphoglycerate mutase,569
SARO_RS01645,Saro_0328,352345,353361,nicotinate-nucleotide--dimethylbenzimidazole phosphoribosyltransferase,1016
SARO_RS01650,Saro_0329,353358,353765,DUF1636 domain-containing protein,407
SARO_RS01655,Saro_0330,353791,354438,5%2C6-dimethylbenzimidazole synthase,647
SARO_RS01660,Saro_0331,354453,355079,cob(I)yrinic acid a%2Cc-diamide adenosyltransferase,626
SARO_RS01665,Saro_0332,355069,355833,precorrin-6A synthase (deacetylating),764
SARO_RS01670,Saro_0333,355830,357164,cobyrinate a%2Cc-diamide synthase,1334
SARO_RS01675,Saro_0334,357161,357946,precorrin-4 C(11)-methyltransferase,785
SARO_RS01680,Saro_0335,357943,358323,precorrin methylase,380
SARO_RS01685,Saro_0336,358320,359528,bifunctional cobalt-precorrin-7 (C(5))-methyltransferase/cobalt-precorrin-6B (C(15))-methyltransferase,1208
SARO_RS01690,Saro_0337,359527,360288,cobalt-precorrin-6A reductase,761
SARO_RS01695,Saro_0338,360252,361025,precorrin-3B C(17)-methyltransferase,773
SARO_RS01700,Saro_0339,361037,361774,precorrin-2 C(20)-methyltransferase,737
SARO_RS01705,Saro_0340,361771,362400,precorrin-8X methylmutase,629
SARO_RS01710,Saro_0341,362400,363545,precorrin-3B synthase,1145
SARO_RS01715,Saro_0342,363542,366826,cobaltochelatase subunit CobN,3284
SARO_RS01720,Saro_0343,366837,367889,cobalamin biosynthesis protein CobW,1052
SARO_RS01725,Saro_0344,368386,369432,HoxN/HupN/NixA family nickel/cobalt transporter,1046
SARO_RS01730,Saro_0345,369514,371610,TonB-dependent receptor,2096
SARO_RS01735,Saro_0346,372308,373762,hypothetical protein,1454
SARO_RS01740,Saro_0348,374343,375047,hypothetical protein,704
SARO_RS01745,Saro_0349,375088,376569,DUF2779 domain-containing protein,1481
SARO_RS20065,Saro_0350,376858,378921,McrBC 5-methylcytosine restriction system component-like,2063
SARO_RS01755,Saro_0351,378931,379908,WYL domain-containing protein,977
SARO_RS01760,Saro_0352,379978,385092,DUF1998 domain-containing protein,5114
SARO_RS01765,Saro_0353,385089,387890,helicase,2801
SARO_RS01770,Saro_0354,387890,391849,type II DNA modification enzyme,3959
SARO_RS20455,Saro_0355,391849,392592,hypothetical protein,743
SARO_RS01780,Saro_0356,392607,393173,hypothetical protein,566
SARO_RS01785,Saro_0357,393322,394233,DNA-binding protein,911
SARO_RS01790,Saro_0358,394230,395027,HNH endonuclease,797
SARO_RS01795,Saro_0359,395159,396898,DUF3363 domain-containing protein,1739
SARO_RS01800,Saro_0360,397143,397844,lytic transglycosylase domain-containing protein,701
SARO_RS01805,Saro_0361,397848,398180,DUF736 domain-containing protein,332
SARO_RS01810,Saro_0362,398177,398755,conjugal transfer protein,578
SARO_RS01815,Saro_0363,398752,399291,DUF2840 domain-containing protein,539
SARO_RS01820,Saro_0364,399438,400316,RepA replication protein,878
SARO_RS01825,Saro_0365,400326,400598,DNA-binding protein,272
SARO_RS20460,Saro_0366,400725,401258,DUF2285 domain-containing protein,533
SARO_RS01835,Saro_0367,401654,401917,DUF2285 domain-containing protein,263
SARO_RS01840,Saro_0368,402133,402363,XRE family transcriptional regulator,230
SARO_RS01845,Saro_0369,402413,402736,DUF736 domain-containing protein,323
SARO_RS01850,NA,402749,402952,hypothetical protein,203
SARO_RS01855,NA,403323,403727,hypothetical protein,404
SARO_RS01860,NA,403872,404105,hypothetical protein,233
SARO_RS01865,Saro_0373,404582,405697,Fic family protein,1115
SARO_RS01870,Saro_0374,406050,407546,SulP family inorganic anion transporter,1496
SARO_RS01875,Saro_0375,407653,408582,DUF2493 domain-containing protein,929
SARO_RS01880,Saro_0376,408916,409953,DNA primase,1037
SARO_RS01885,Saro_0377,410029,414408,methylase,4379
SARO_RS01890,Saro_0378,414602,415432,hypothetical protein,830
SARO_RS01895,Saro_0379,415429,415902,hypothetical protein,473
SARO_RS01900,Saro_0380,416008,418149,DNA-binding protein,2141
SARO_RS01905,Saro_0381,418306,419244,DUF1738 domain-containing protein,938
SARO_RS01910,Saro_0382,419819,420133,conjugal transfer protein TraR,314
SARO_RS01915,Saro_0383,420278,421420,hypothetical protein,1142
SARO_RS01920,Saro_0384,421508,422518,cation transporter,1010
SARO_RS01925,Saro_0385,422876,423853,serine hydrolase,977
SARO_RS01930,Saro_0386,423854,424543,DNA-binding response regulator,689
SARO_RS01935,Saro_0387,424543,426051,DUF4118 domain-containing protein,1508
SARO_RS01940,Saro_0388,426165,426689,peptidoglycan-associated lipoprotein Pal,524
SARO_RS01945,Saro_0389,426706,426993,hypothetical protein,287
SARO_RS01950,Saro_0390,427167,427850,protein TolQ,683
SARO_RS01955,Saro_0391,427850,428329,biopolymer transporter ExbD,479
SARO_RS01960,Saro_0392,428326,429432,hypothetical protein,1106
SARO_RS01965,Saro_0393,429429,430784,protein TolB 1,1355
SARO_RS01970,Saro_0394,431251,431793,DUF2062 domain-containing protein,542
SARO_RS01975,Saro_0395,431736,433526,hypothetical protein,1790
SARO_RS01980,Saro_0396,433539,434387,universal stress protein,848
SARO_RS01985,Saro_0397,434462,435793,ATPase,1331
SARO_RS01990,Saro_0398,435786,436460,TrkA family potassium uptake protein,674
SARO_RS01995,Saro_0399,436525,439260,carbonate dehydratase,2735
SARO_RS02000,Saro_0400,439359,440204,universal stress protein,845
SARO_RS02005,Saro_0401,440475,441857,serine protease,1382
SARO_RS02010,Saro_0402,441880,442653,membrane protein,773
SARO_RS02015,Saro_0403,442737,443264,hypothetical protein,527
SARO_RS02020,Saro_0404,443284,443673,DUF302 domain-containing protein,389
SARO_RS02025,Saro_0405,443690,445009,carboxylate transporter,1319
SARO_RS02030,NA,445233,446018,hypothetical protein,785
SARO_RS02035,Saro_0407,446037,447314,Na+/H+ antiporter NhaA 1,1277
SARO_RS02040,Saro_0408,447796,448563,sulfite exporter TauE/SafE family protein,767
SARO_RS02045,Saro_0409,448658,449185,hypothetical protein,527
SARO_RS02050,Saro_0410,449193,450791,L-aspartate oxidase,1598
SARO_RS02055,Saro_0411,451251,452222,ABC transporter ATP-binding protein,971
SARO_RS02060,Saro_0412,452294,452494,zinc-finger domain-containing protein,200
SARO_RS02065,Saro_0413,452563,454002,metalloprotease TldD,1439
SARO_RS02070,Saro_0414,454077,454475,glutathione-dependent formaldehyde-activating protein,398
SARO_RS02075,Saro_0415,454543,454965,hypothetical protein,422
SARO_RS02080,Saro_0416,455007,455561,N-acetyltransferase,554
SARO_RS02085,Saro_0417,455622,456746,flavodoxin-dependent (E)-4-hydroxy-3-methylbut-2-enyl-diphosphate synthase,1124
SARO_RS02090,Saro_0418,456748,457479,CPBP family intramembrane metalloprotease,731
SARO_RS02095,Saro_0419,457574,458338,YebC/PmpR family DNA-binding transcriptional regulator,764
SARO_RS02100,Saro_0420,458344,458694,hypothetical protein,350
SARO_RS02105,Saro_0421,458696,459172,crossover junction endodeoxyribonuclease RuvC,476
SARO_RS02110,Saro_0422,459269,459883,Holliday junction branch migration protein RuvA,614
SARO_RS02115,Saro_0423,459887,460915,Holliday junction branch migration DNA helicase RuvB,1028
SARO_RS20470,Saro_0424,461134,462072,PEP-CTERM sorting domain-containing protein,938
SARO_RS02125,Saro_0425,462232,464904,aconitate hydratase AcnA,2672
SARO_RS02130,Saro_0426,465142,466032,EamA/RhaT family transporter,890
SARO_RS02135,Saro_0427,466174,467673,L%2CD-transpeptidase,1499
SARO_RS02140,NA,467681,467896,hypothetical protein,215
SARO_RS02145,Saro_0428,467869,468492,twin-arginine translocation pathway signal protein,623
SARO_RS02150,Saro_0429,468544,469047,N-acetyltransferase,503
SARO_RS02155,Saro_0430,469082,469318,DUF2312 domain-containing protein,236
SARO_RS02160,Saro_0431,469415,469753,DUF1244 domain-containing protein,338
SARO_RS02165,Saro_0432,469777,471252,pyruvate kinase,1475
SARO_RS02170,Saro_0433,471309,471974,YggS family pyridoxal phosphate-dependent enzyme,665
SARO_RS02175,Saro_0434,471997,472533,thiamine monophosphate synthase,536
SARO_RS02180,Saro_0435,472628,475009,DNA translocase FtsK,2381
SARO_RS02185,Saro_0436,475017,475415,acyl-CoA thioesterase,398
SARO_RS02190,Saro_0437,475412,477487,S9 family peptidase,2075
SARO_RS02195,Saro_0438,477550,479349,aminopeptidase P family protein,1799
SARO_RS02200,Saro_0439,479405,479773,VOC family protein,368
SARO_RS02205,Saro_0440,480001,480681,calcium-binding EF-hand protein,680
SARO_RS02210,Saro_0441,480687,481424,DNA-binding response regulator,737
SARO_RS02215,Saro_0442,481428,482825,two-component sensor histidine kinase,1397
SARO_RS02220,Saro_0443,482963,485629,aminopeptidase N,2666
SARO_RS02225,Saro_0444,485699,487273,ATP-binding protein,1574
SARO_RS02230,Saro_0445,487393,489180,aminodeoxychorismate synthase%2C component I,1787
SARO_RS02235,Saro_0446,489185,490354,pyridoxal phosphate-dependent aminotransferase,1169
SARO_RS02240,Saro_0447,490351,491019,RNA pseudouridine synthase,668
SARO_RS02245,Saro_0448,491021,491434,aminoacyl-tRNA hydrolase,413
SARO_RS02250,Saro_0449,491483,492766,UDP-N-acetylglucosamine 1-carboxyvinyltransferase,1283
SARO_RS02255,Saro_0450,492906,493802,UTP--glucose-1-phosphate uridylyltransferase,896
SARO_RS02260,Saro_0451,493816,494490,TetR/AcrR family transcriptional regulator,674
SARO_RS02265,Saro_0452,494678,495793,gfo/Idh/MocA family oxidoreductase,1115
SARO_RS02270,Saro_0453,495805,496860,sugar phosphate isomerase/epimerase,1055
SARO_RS02275,Saro_0454,497246,499669,TonB-dependent receptor,2423
SARO_RS02280,Saro_0455,499747,500358,thioredoxin family protein,611
SARO_RS02285,Saro_0456,500603,501355,electron transfer flavoprotein subunit beta/FixA family protein,752
SARO_RS02290,Saro_0457,501355,502287,electron transfer flavoprotein subunit alpha/FixB family protein,932
SARO_RS02295,Saro_0458,502454,503392,hypothetical protein,938
SARO_RS02300,Saro_0459,503393,503857,N-acetyltransferase,464
SARO_RS02305,Saro_0460,504045,504479,hypothetical protein,434
SARO_RS02310,Saro_0461,504527,505498,RDD family protein,971
SARO_RS02315,Saro_0462,505498,506568,membrane protein,1070
SARO_RS02320,Saro_0463,506565,507851,DUF58 domain-containing protein,1286
SARO_RS02325,Saro_0464,507890,508846,MoxR family ATPase,956
SARO_RS02330,Saro_0465,508864,510147,hypothetical protein,1283
SARO_RS02335,Saro_0466,510144,510803,hypothetical protein,659
SARO_RS02340,Saro_0467,510856,511746,prephenate dehydratase,890
SARO_RS02345,NA,511901,512791,cytochrome c family protein,890
SARO_RS02350,Saro_0469,512851,513276,transcriptional regulator,425
SARO_RS02355,Saro_0470,513332,513940,NAD(P)-dependent oxidoreductase,608
SARO_RS02360,Saro_0471,513974,514474,hypothetical protein,500
SARO_RS02365,Saro_0472,514536,515204,ribosomal RNA large subunit methyltransferase E,668
SARO_RS02370,Saro_0473,515201,516508,exopolyphosphatase,1307
SARO_RS02380,Saro_0474,516979,518454,twin-arginine translocation pathway signal protein,1475
SARO_RS02385,Saro_0475,518616,519611,aldo/keto reductase,995
SARO_RS02395,Saro_0477,520686,521564,LOG family protein,878
SARO_RS02400,Saro_0478,521569,522087,N-acetyltransferase,518
SARO_RS02405,Saro_0479,522072,522821,bifunctional hydroxymethylpyrimidine kinase/phosphomethylpyrimidine kinase,749
SARO_RS02410,Saro_0480,522823,523047,DUF1272 domain-containing protein,224
SARO_RS02415,Saro_0481,523049,524386,phosphoglucosamine mutase,1337
SARO_RS02420,Saro_0482,524457,525746,dicarboxylate/amino acid:cation symporter,1289
SARO_RS02425,Saro_0483,525874,526488,superoxide dismutase,614
SARO_RS02430,Saro_0484,526476,527696,AI-2E family transporter,1220
SARO_RS02435,Saro_0485,527833,528441,DNA-directed RNA polymerase sigma-70 factor,608
SARO_RS02440,Saro_0487,528858,530525,histidine kinase,1667
SARO_RS02445,Saro_0488,530563,531360,response regulator,797
SARO_RS20070,Saro_0489,531406,531810,response regulator,404
SARO_RS02455,Saro_0490,531932,532702,Crp/Fnr family transcriptional regulator,770
SARO_RS02460,Saro_0491,532919,533383,response regulator,464
SARO_RS02465,Saro_0492,533476,534636,hypothetical protein,1160
SARO_RS02470,Saro_0493,534801,535892,fatty acid desaturase,1091
SARO_RS02475,Saro_0494,535912,536424,DUF2892 domain-containing protein,512
SARO_RS02480,Saro_0495,536474,537574,LPS export ABC transporter permease LptG,1100
SARO_RS02485,Saro_0496,537564,538808,LPS export ABC transporter permease LptF,1244
SARO_RS02490,Saro_0497,539046,539477,hypothetical protein,431
SARO_RS02495,Saro_0498,539558,539938,ATP-dependent Clp protease adapter ClpS,380
SARO_RS02500,Saro_0499,540114,540980,phasin,866
SARO_RS02505,Saro_0500,541124,543028,class I poly(R)-hydroxyalkanoic acid synthase,1904
SARO_RS02510,Saro_0501,543158,544357,pyridoxal phosphate-dependent aminotransferase,1199
SARO_RS02515,Saro_0502,544498,545304,enoyl-CoA hydratase,806
SARO_RS02520,Saro_0503,545339,546724,RNB domain-containing ribonuclease,1385
SARO_RS20475,Saro_0504,547296,547607,YHYH domain-containing protein,311
SARO_RS02530,NA,548134,548331,hypothetical protein,197
SARO_RS20490,NA,548866,549623,IS5/IS1182 family transposase,757
SARO_RS20490,NA,548866,549623,IS5/IS1182 family transposase,757
SARO_RS20495,NA,549846,549968,hypothetical protein,122
SARO_RS20505,Saro_0509,550240,550557,ferredoxin,317
SARO_RS02550,Saro_0510,550605,552242,NAD(P)/FAD-dependent oxidoreductase,1637
SARO_RS02555,Saro_0511,552466,553236,crotonase,770
SARO_RS02560,Saro_0512,553249,553995,3-oxoacyl-ACP reductase,746
SARO_RS02565,Saro_0513,554310,555392,5-exo-alcohol dehydrogenase,1082
SARO_RS02570,Saro_0514,555434,556699,cytochrome P450,1265
SARO_RS02575,Saro_0515,556696,557178,flavin reductase,482
SARO_RS02580,Saro_0516,557175,557762,TetR/AcrR family transcriptional regulator,587
SARO_RS02585,Saro_0517,557813,558748,SMP-30/gluconolactonase/LRE family protein,935
SARO_RS02590,Saro_0518,558851,559693,enoyl-CoA hydratase/isomerase family protein,842
SARO_RS02595,Saro_0519,559882,561576,long-chain fatty acid--CoA ligase,1694
SARO_RS02600,Saro_0520,561623,562768,3%2C4-dihydroxy-2-butanone-4-phosphate synthase,1145
SARO_RS02605,Saro_0521,562789,563454,TetR/AcrR family transcriptional regulator,665
SARO_RS02610,Saro_0522,563635,564759,LLM class flavin-dependent oxidoreductase,1124
SARO_RS02615,Saro_0523,564837,567248,TonB-dependent receptor,2411
SARO_RS20510,NA,567783,568085,FAD-dependent oxidoreductase,302
SARO_RS02620,Saro_0525,567941,568555,hypothetical protein,614
SARO_RS02625,Saro_0526,568755,570248,recombinase family protein,1493
SARO_RS02630,Saro_0527,570248,571147,chromosome partitioning protein ParB,899
SARO_RS02635,Saro_0528,571140,572099,RepB plasmid partition,959
SARO_RS20080,Saro_0530,573909,575255,hypothetical protein,1346
SARO_RS02645,Saro_0531,575338,576552,acyltransferase,1214
SARO_RS02650,Saro_0532,576491,577765,TetR/AcrR family transcriptional regulator,1274
SARO_RS02655,Saro_0533,577801,580191,arylsulfatase,2390
SARO_RS02660,Saro_0534,580304,582577,arylsulfatase,2273
SARO_RS02665,Saro_0535,582643,585204,TonB-dependent receptor,2561
SARO_RS02670,Saro_0536,585376,586290,formylglycine-generating enzyme family protein,914
SARO_RS02675,Saro_0537,586351,587277,LysR family transcriptional regulator,926
SARO_RS02680,Saro_0538,587562,588896,benzoate 1%2C2-dioxygenase subunit alpha,1334
SARO_RS02685,Saro_0539,588893,589378,benzoate 1%2C2-dioxygenase small subunit,485
SARO_RS02690,Saro_0540,589371,590162,1%2C6-dihydroxycyclohexa-2%2C4-diene-1-carboxylate dehydrogenase,791
SARO_RS02695,Saro_0541,590232,591146,LysR family transcriptional regulator,914
SARO_RS02700,Saro_0542,591233,592552,glycoside hydrolase family 1 protein,1319
SARO_RS02705,Saro_0543,592634,593659,UDP-glucose--hexose-1-phosphate uridylyltransferase,1025
SARO_RS02710,Saro_0544,593656,594798,galactokinase,1142
SARO_RS02715,Saro_0545,594815,597991,autotransporter domain-containing protein,3176
SARO_RS02720,Saro_0546,598289,598936,RNA polymerase sigma factor,647
SARO_RS02725,Saro_0547,598936,599712,hypothetical protein,776
SARO_RS02730,Saro_0548,599767,600258,asparaginase,491
SARO_RS02735,Saro_0549,600266,600691,GNAT family acetyltransferase,425
SARO_RS02740,Saro_0550,600682,602241,glutamine-hydrolyzing GMP synthase,1559
SARO_RS02745,Saro_0551,602665,603510,tRNA glutamyl-Q synthetase,845
SARO_RS02750,Saro_0552,603507,603737,hypothetical protein,230
SARO_RS02755,Saro_0553,603757,604317,ATP:cob(I)alamin adenosyltransferase,560
SARO_RS02760,Saro_0554,604391,605263,3-hydroxybutyryl-CoA dehydrogenase,872
SARO_RS02765,Saro_0555,605322,605684,hypothetical protein,362
SARO_RS02770,Saro_0556,605947,606279,hypothetical protein,332
SARO_RS02775,NA,606296,606475,hypothetical protein,179
SARO_RS02780,Saro_0557,606585,607016,nuclease,431
SARO_RS02785,Saro_0558,607023,607658,TetR/AcrR family transcriptional regulator,635
SARO_RS02790,Saro_0559,607830,609581,bifunctional metallophosphatase/5'-nucleotidase,1751
SARO_RS02795,Saro_0560,609600,610397,DUF1295 domain-containing protein,797
SARO_RS02800,Saro_0561,610390,611001,acyltransferase,611
SARO_RS02805,Saro_0562,611046,611723,hypothetical protein,677
SARO_RS02810,Saro_0563,611833,612276,DUF983 domain-containing protein,443
SARO_RS02815,Saro_0564,612277,612960,glutathione S-transferase,683
SARO_RS02820,Saro_0565,612965,613513,glutathione peroxidase,548
SARO_RS02825,Saro_0566,613531,614190,CoA transferase subunit B,659
SARO_RS02830,Saro_0567,614213,615103,hypothetical protein,890
SARO_RS02835,Saro_0568,615106,615816,CoA transferase subunit A,710
SARO_RS02840,Saro_0569,615911,616783,LysR family transcriptional regulator,872
SARO_RS02845,Saro_0570,616832,617476,haloacid dehalogenase,644
SARO_RS02850,Saro_0571,617619,618398,universal stress protein,779
SARO_RS20085,Saro_0572,618437,618913,hypothetical protein,476
SARO_RS02860,Saro_0573,619329,621647,ATPase AAA,2318
SARO_RS02865,Saro_0574,621723,623030,signal transduction histidine kinase,1307
SARO_RS02870,Saro_0575,623203,623337,50S ribosomal protein L34,134
SARO_RS02875,NA,623392,623862,ribonuclease P protein component,470
SARO_RS20515,Saro_0577,623859,624068,membrane protein insertion efficiency factor,209
SARO_RS02885,Saro_0578,624133,625935,membrane protein insertase YidC,1802
SARO_RS02890,Saro_0579,625932,626585,GTP-binding protein,653
SARO_RS02895,Saro_0580,626906,627580,glutathione S-transferase,674
SARO_RS02900,Saro_0581,627580,628707,succinyl-diaminopimelate desuccinylase,1127
SARO_RS02905,Saro_0582,628691,629266,DNA mismatch repair protein MutS,575
SARO_RS02910,Saro_0583,629263,630486,MltA,1223
SARO_RS02915,Saro_0584,630495,631238,Tim44 domain-containing protein,743
SARO_RS02920,Saro_0586,631473,631994,protein-export protein SecB,521
SARO_RS02925,Saro_0587,632025,633596,murein biosynthesis integral membrane protein MurJ,1571
SARO_RS02930,Saro_0588,633608,634627,tryptophan--tRNA ligase,1019
SARO_RS02935,Saro_0589,634798,635496,DUF4136 domain-containing protein,698
SARO_RS02940,Saro_0590,635565,636032,dUTP diphosphatase,467
SARO_RS02945,Saro_0591,636019,637206,bifunctional phosphopantothenoylcysteine decarboxylase/phosphopantothenate--cysteine ligase CoaBC,1187
SARO_RS02950,Saro_0592,637311,637709,hypothetical protein,398
SARO_RS02955,Saro_0593,637714,638733,acyltransferase,1019
SARO_RS02960,Saro_0594,638968,640527,2-polyprenylphenol 6-hydroxylase,1559
SARO_RS02965,Saro_0595,640532,641269,class I SAM-dependent methyltransferase,737
SARO_RS02970,Saro_0596,641330,642142,formamidopyrimidine-DNA glycosylase,812
SARO_RS02975,Saro_0597,642174,643280,4-hydroxyphenylpyruvate dioxygenase,1106
SARO_RS02980,Saro_0598,643436,643897,Lrp/AsnC family transcriptional regulator,461
SARO_RS02985,Saro_0599,644032,644970,LysR family transcriptional regulator,938
SARO_RS02990,Saro_0600,645059,645979,sterol desaturase,920
SARO_RS02995,Saro_0601,645976,647553,sulfotransferase family protein,1577
SARO_RS03000,Saro_0602,647570,647929,hypothetical protein,359
SARO_RS03005,Saro_0603,648049,648384,UrcA family protein,335
SARO_RS03010,Saro_0604,648439,649371,hypothetical protein,932
SARO_RS03015,Saro_0605,649374,651143,allophanate hydrolase,1769
SARO_RS03020,Saro_0606,651140,654733,urea carboxylase,3593
SARO_RS03025,Saro_0607,654730,655365,DUF1989 domain-containing protein,635
SARO_RS03030,Saro_0608,655382,656206,DUF1989 domain-containing protein,824
SARO_RS03035,Saro_0609,656203,656679,ribbon-helix-helix protein%2C CopG family,476
SARO_RS03040,Saro_0610,656681,657466,lauroyl acyltransferase,785
SARO_RS03045,Saro_0611,657484,658299,lipid kinase,815
SARO_RS03050,Saro_0612,658339,659421,lipid kinase,1082
SARO_RS03060,Saro_0613,660041,662467,TonB-dependent receptor,2426
SARO_RS03065,Saro_0614,662553,663497,hypothetical protein,944
SARO_RS03070,Saro_0615,663645,664640,sterol desaturase,995
SARO_RS03075,Saro_0616,664669,665286,hypothetical protein,617
SARO_RS03085,Saro_0617,665462,666613,site-specific integrase,1151
SARO_RS03090,Saro_0618,666617,666838,hypothetical protein,221
SARO_RS03095,Saro_0619,666842,667162,hypothetical protein,320
SARO_RS03100,Saro_0620,667159,667779,MT-A70,620
SARO_RS03105,Saro_0621,667779,668300,DNA repair protein MmcB-related protein,521
SARO_RS03110,Saro_0622,668297,668983,hypothetical protein,686
SARO_RS03115,Saro_0623,668987,669502,hypothetical protein,515
SARO_RS03120,Saro_0624,669506,669823,hypothetical protein,317
SARO_RS20090,Saro_0625,669827,671284,ParB-like nuclease,1457
SARO_RS03130,Saro_0626,671305,672378,hypothetical protein,1073
SARO_RS03135,Saro_0627,672375,672668,hypothetical protein,293
SARO_RS03140,Saro_0629,673218,673670,hypothetical protein,452
SARO_RS03145,Saro_0630,673793,674125,hypothetical protein,332
SARO_RS03150,Saro_0631,674200,674433,hypothetical protein,233
SARO_RS20525,Saro_0632,674523,675227,hypothetical protein,704
SARO_RS03160,Saro_0633,675176,675802,XRE family transcriptional regulator,626
SARO_RS03165,NA,675852,676139,hypothetical protein,287
SARO_RS03170,Saro_0635,676226,676456,hypothetical protein,230
SARO_RS03175,Saro_0636,676567,677037,hypothetical protein,470
SARO_RS03180,Saro_0637,677034,677600,hypothetical protein,566
SARO_RS03185,Saro_0638,677651,677956,hypothetical protein,305
SARO_RS03190,NA,677953,679200,DNA polymerase III subunit beta,1247
SARO_RS03200,NA,679275,681137,DNA primase,1862
SARO_RS03205,Saro_0642,681134,682756,Phage or plasmid primase P4-like,1622
SARO_RS03210,Saro_0643,683070,683543,hypothetical protein,473
SARO_RS03215,Saro_0644,683751,684059,HNH endonuclease,308
SARO_RS03220,NA,684404,684628,hypothetical protein,224
SARO_RS03225,Saro_0646,684636,686372,terminase large subunit,1736
SARO_RS03230,Saro_0647,686369,687673,phage portal protein,1304
SARO_RS03235,Saro_0648,687663,688358,HK97 family phage prohead protease,695
SARO_RS03240,Saro_0649,688371,689768,phage major capsid protein,1397
SARO_RS03245,NA,689846,690067,hypothetical protein,221
SARO_RS03250,Saro_0651,690125,690487,hypothetical protein,362
SARO_RS20095,Saro_0652,690557,691102,hypothetical protein,545
SARO_RS03260,NA,691102,691452,head-tail adaptor protein,350
SARO_RS03265,Saro_0654,691488,692093,Phage protein%2C HK97%2C gp10,605
SARO_RS03270,Saro_0655,692086,692493,DUF3168 domain-containing protein,407
SARO_RS03275,Saro_0656,692508,692723,hypothetical protein,215
SARO_RS03280,Saro_0657,692812,693273,hypothetical protein,461
SARO_RS03285,Saro_0658,693380,693796,hypothetical protein,416
SARO_RS03290,NA,693892,694263,hypothetical protein,371
SARO_RS03295,Saro_0660,694266,697238,hypothetical protein,2972
SARO_RS03300,Saro_0661,697235,698281,hypothetical protein,1046
SARO_RS03305,Saro_0662,698287,699117,hypothetical protein,830
SARO_RS03310,Saro_0663,699232,700221,hypothetical protein,989
SARO_RS03315,Saro_0664,700510,702399,hypothetical protein,1889
SARO_RS03320,Saro_0665,702396,702740,hypothetical protein,344
SARO_RS03325,Saro_0666,702737,703276,hypothetical protein,539
SARO_RS03330,Saro_0667,703273,703542,hypothetical protein,269
SARO_RS20530,Saro_0668,703539,703835,hypothetical protein,296
SARO_RS03340,Saro_0669,704132,706129,hypothetical protein,1997
SARO_RS03345,Saro_0670,706136,707506,hypothetical protein,1370
SARO_RS03350,Saro_0671,707757,708095,hypothetical protein,338
SARO_RS03355,Saro_0672,708399,708689,DUF2218 domain-containing protein,290
SARO_RS03360,Saro_0673,708788,709732,2-keto-4-pentenoate hydratase,944
SARO_RS03365,Saro_0674,709795,711912,CoA-binding protein,2117
SARO_RS03370,Saro_0675,711968,712504,adenine phosphoribosyltransferase,536
SARO_RS03375,Saro_0676,712582,713397,cytochrome c1,815
SARO_RS03380,Saro_0677,713428,714717,cytochrome b,1289
SARO_RS03385,Saro_0678,714729,715307,ubiquinol-cytochrome c reductase iron-sulfur subunit,578
SARO_RS03390,Saro_0679,715567,716622,SAM-dependent methyltransferase,1055
SARO_RS03395,Saro_0680,716619,717518,prolipoprotein diacylglyceryl transferase,899
SARO_RS03400,Saro_0681,717676,719388,AMP-dependent synthetase,1712
SARO_RS03405,Saro_0682,719450,722191,[protein-PII] uridylyltransferase,2741
SARO_RS03410,Saro_0683,722249,722809,DUF179 domain-containing protein,560
SARO_RS03415,Saro_0684,723040,723945,homoserine O-succinyltransferase,905
SARO_RS03420,Saro_0685,724127,724330,50S ribosomal protein L35,203
SARO_RS03425,Saro_0686,724344,724706,50S ribosomal protein L20,362
SARO_RS03430,Saro_0687,724842,725723,AraC family transcriptional regulator,881
SARO_RS03435,Saro_0688,725769,726869,phenylalanine--tRNA ligase subunit alpha,1100
SARO_RS03440,Saro_0689,726866,729256,phenylalanine--tRNA ligase subunit beta,2390
SARO_RS03445,Saro_0690,729333,730856,peptide chain release factor 3,1523
SARO_RS03450,Saro_0691,730917,731789,alpha/beta hydrolase,872
SARO_RS03455,Saro_0692,731798,732535,endonuclease,737
SARO_RS03460,Saro_0693,732711,733049,P-II family nitrogen regulator,338
SARO_RS03465,Saro_0694,733085,734404,ammonium transporter,1319
SARO_RS03470,Saro_0695,734586,735704,histidinol-phosphate aminotransferase,1118
SARO_RS03475,Saro_0696,735701,736654,prephenate dehydrogenase/arogenate dehydrogenase family protein,953
SARO_RS03480,Saro_0697,736651,737943,divalent metal cation transporter,1292
SARO_RS03485,Saro_0698,737927,738610,1-acyl-sn-glycerol-3-phosphate acyltransferase,683
SARO_RS03490,Saro_0699,738625,739173,YdcF family protein,548
SARO_RS03495,Saro_0700,739170,740105,cell division protein,935
SARO_RS03500,Saro_0701,740102,740866,cell division ATP-binding protein FtsE,764
SARO_RS03505,Saro_0702,741015,741899,thioredoxin,884
SARO_RS03515,Saro_0703,742296,743213,NAD(P)-dependent oxidoreductase,917
SARO_RS03520,Saro_0704,743286,746729,bifunctional proline dehydrogenase/L-glutamate gamma-semialdehyde dehydrogenase PutA,3443
SARO_RS03525,Saro_0705,746833,747303,Lrp/AsnC family transcriptional regulator,470
SARO_RS03530,Saro_0706,747278,747925,TetR/AcrR family transcriptional regulator,647
SARO_RS03535,Saro_0707,747979,749004,aromatic ring-hydroxylating dioxygenase subunit alpha,1025
SARO_RS03540,Saro_0708,749075,749500,polyketide cyclase,425
SARO_RS03545,NA,749500,749889,hypothetical protein,389
SARO_RS03550,Saro_0710,749871,750902,xylose isomerase,1031
SARO_RS03555,Saro_0711,750994,752226,MFS transporter,1232
SARO_RS03560,Saro_0712,752468,753583,FAD-binding protein,1115
SARO_RS03565,Saro_0713,753607,754509,glyoxalase,902
SARO_RS03570,Saro_0714,754513,755670,alpha/beta hydrolase,1157
SARO_RS03575,Saro_0715,755671,756129,hypothetical protein,458
SARO_RS03580,Saro_0716,756152,756931,cyclase,779
SARO_RS03585,Saro_0717,756948,757568,ATP-dependent dethiobiotin synthetase BioD,620
SARO_RS03590,Saro_0718,757565,758713,8-amino-7-oxononanoate synthase,1148
SARO_RS03595,Saro_0719,758713,759783,biotin synthase,1070
SARO_RS03600,Saro_0720,759902,760549,ABC transporter ATP-binding protein,647
SARO_RS03605,Saro_0721,760546,761343,capsule polysaccharide transporter,797
SARO_RS03610,Saro_0722,761345,762502,capsule polysaccharide export ABC transporter protein,1157
SARO_RS03615,Saro_0723,762499,763257,methyltransferase domain-containing protein,758
SARO_RS20100,Saro_0724,763254,765296,DUF616 domain-containing protein,2042
SARO_RS20105,Saro_0725,765335,767341,methyltransferase domain-containing protein,2006
SARO_RS03630,Saro_0726,767334,768185,3-deoxy-8-phosphooctulonate synthase,851
SARO_RS03635,NA,768182,769204,KpsF/GutQ family sugar-phosphate isomerase,1022
SARO_RS03640,Saro_0728,769458,770678,capsule polysaccharide transporter,1220
SARO_RS03645,Saro_0729,770732,772492,glycosyl transferase,1760
SARO_RS03650,Saro_0730,772489,773442,hypothetical protein,953
SARO_RS03655,NA,773446,774426,capsule polysaccharide biosynthesis,980
SARO_RS03660,Saro_0732,774648,775061,NADH-quinone oxidoreductase subunit E,413
SARO_RS03665,Saro_0733,775058,776596,formate dehydrogenase subunit beta,1538
SARO_RS03670,Saro_0734,776593,777126,molybdenum cofactor guanylyltransferase,533
SARO_RS03675,Saro_0735,777116,779974,formate dehydrogenase subunit alpha,2858
SARO_RS03680,NA,779971,780237,hypothetical protein,266
SARO_RS03685,Saro_0737,780218,781012,sulfurtransferase FdhD,794
SARO_RS03690,NA,780966,781436,response regulator,470
SARO_RS03695,Saro_0739,781532,782284,hypothetical protein,752
SARO_RS03700,Saro_0740,782384,784855,glycosyl transferase family 1,2471
SARO_RS03705,Saro_0741,784842,786134,glycosidase,1292
SARO_RS03710,Saro_0742,786182,787222,mannose-1-phosphate guanylyltransferase,1040
SARO_RS03715,Saro_0743,787219,788022,mannose-6-phosphate isomerase,803
SARO_RS20110,Saro_0744,788181,789335,glycosyltransferase family 1 protein,1154
SARO_RS03725,Saro_0745,789614,790894,glycosyltransferase family 1 protein,1280
SARO_RS03730,Saro_0746,790968,792065,capsule polysaccharide export inner-membrane protein,1097
SARO_RS03735,Saro_0747,792065,792868,sugar ABC transporter permease,803
SARO_RS03740,Saro_0748,792865,793563,ABC transporter ATP-binding protein,698
SARO_RS03745,NA,793671,794450,class I SAM-dependent methyltransferase,779
SARO_RS20115,Saro_0750,794375,796771,glycosyltransferase family 1 protein,2396
SARO_RS03755,Saro_0751,796771,797691,FkbM family methyltransferase,920
SARO_RS03760,Saro_0752,797758,799029,glycosyltransferase family 1 protein,1271
SARO_RS03765,Saro_0753,799043,800221,capsular polysaccharide biosynthesis protein,1178
SARO_RS03770,Saro_0754,800381,802510,TonB-dependent receptor,2129
SARO_RS03775,Saro_0755,802606,803679,LacI family DNA-binding transcriptional regulator,1073
SARO_RS03780,Saro_0756,803799,805238,xylulokinase,1439
SARO_RS03785,Saro_0757,805250,806563,xylose isomerase,1313
SARO_RS03790,Saro_0758,807011,807910,AraC family transcriptional regulator,899
SARO_RS03795,Saro_0759,807907,809118,cytochrome P450,1211
SARO_RS03800,Saro_0760,809121,811361,TonB-dependent receptor,2240
SARO_RS03805,Saro_0762,812004,812432,hypothetical protein,428
SARO_RS03810,Saro_0763,812451,813524,hypothetical protein,1073
SARO_RS03815,Saro_0764,813526,816048,fimbrial biogenesis outer membrane usher protein,2522
SARO_RS03820,Saro_0765,816051,816803,molecular chaperone,752
SARO_RS03825,Saro_0766,816842,817414,hypothetical protein,572
SARO_RS03830,Saro_0767,817414,818019,hypothetical protein,605
SARO_RS03835,Saro_0768,818022,818591,hypothetical protein,569
SARO_RS03840,Saro_0769,818597,819172,hypothetical protein,575
SARO_RS03845,Saro_0770,819213,819710,hypothetical protein,497
SARO_RS03850,Saro_0771,819769,820344,hypothetical protein,575
SARO_RS03855,NA,820417,820890,hypothetical protein,473
SARO_RS03860,NA,821539,822216,hypothetical protein,677
SARO_RS03865,Saro_0774,822519,823604,alpha-hydroxy-acid oxidizing protein,1085
SARO_RS03870,Saro_0775,823625,824596,DUF1080 domain-containing protein,971
SARO_RS03875,Saro_0776,824644,825819,gfo/Idh/MocA family oxidoreductase,1175
SARO_RS20120,NA,826039,826230,hypothetical protein,191
SARO_RS20540,NA,826246,826389,hypothetical protein,143
SARO_RS03885,Saro_0778,826510,827112,TetR/AcrR family transcriptional regulator,602
SARO_RS03890,Saro_0779,827238,829526,hypothetical protein,2288
SARO_RS03895,Saro_0780,829618,830526,xylose isomerase,908
SARO_RS03900,Saro_0781,830561,830965,hypothetical protein,404
SARO_RS03905,Saro_0782,831038,831862,phytanoyl-CoA dioxygenase family protein,824
SARO_RS20125,Saro_0784,832239,832853,TetR/AcrR family transcriptional regulator,614
SARO_RS03915,Saro_0785,832996,833913,sugar phosphate isomerase/epimerase,917
SARO_RS03920,Saro_0786,833906,834310,hypothetical protein,404
SARO_RS03925,Saro_0787,834388,836754,TonB-dependent receptor,2366
SARO_RS03930,Saro_0788,836845,837762,alpha/beta hydrolase,917
SARO_RS03935,Saro_0789,837765,839096,glycoside hydrolase family 1 protein,1331
SARO_RS03940,Saro_0790,839311,839643,IS6 family transposase,332
SARO_RS03950,Saro_0791,840137,840940,DUF1134 domain-containing protein,803
SARO_RS03955,Saro_0792,840993,842240,aspartate/tyrosine/aromatic aminotransferase,1247
SARO_RS03960,Saro_0793,842319,843251,KR domain-containing protein,932
SARO_RS03965,Saro_0794,843248,844180,KR domain-containing protein,932
SARO_RS03970,Saro_0795,844342,845796,MFS transporter,1454
SARO_RS03975,Saro_0796,845889,846629,nuclear transport factor 2 family protein,740
SARO_RS03980,Saro_0797,846804,848210,NAD-dependent succinate-semialdehyde dehydrogenase,1406
SARO_RS03985,Saro_0798,848253,848978,DUF2490 domain-containing protein,725
SARO_RS03990,Saro_0799,849016,850071,amidohydrolase,1055
SARO_RS03995,Saro_0800,850094,851695,MFS transporter,1601
SARO_RS04000,Saro_0801,851855,852331,DUF3237 domain-containing protein,476
SARO_RS04005,Saro_0802,852328,853812,lignostilbene alpha-beta-dioxygenase,1484
SARO_RS04010,Saro_0803,853881,854354,MarR family transcriptional regulator,473
SARO_RS04015,Saro_0804,854402,855700,MFS transporter,1298
SARO_RS04020,Saro_0805,855966,857228,membrane dipeptidase,1262
SARO_RS04025,Saro_0806,857600,857980,VOC family protein,380
SARO_RS04030,Saro_0807,858057,859466,XRE family transcriptional regulator,1409
SARO_RS04035,Saro_0808,859691,861217,acyl-CoA carboxylase subunit beta,1526
SARO_RS04040,Saro_0809,861245,862423,acetyl-CoA C-acyltransferase,1178
SARO_RS04045,Saro_0810,862426,862866,methylmalonyl-CoA epimerase,440
SARO_RS04050,Saro_0811,862984,865128,methylmalonyl-CoA mutase,2144
SARO_RS04055,Saro_0813,865399,866682,aminotransferase class V-fold PLP-dependent enzyme,1283
SARO_RS04060,Saro_0814,866733,867068,endonuclease,335
SARO_RS04065,NA,867313,867522,hypothetical protein,209
SARO_RS04070,Saro_0815,867522,869543,acetyl/propionyl/methylcrotonyl-CoA carboxylase subunit alpha,2021
SARO_RS04075,Saro_0816,869612,871045,FAD-binding protein,1433
SARO_RS04080,Saro_0817,871129,871578,cytochrome c family protein,449
SARO_RS04085,Saro_0818,871589,873526,alkyl sulfatase,1937
SARO_RS04090,Saro_0819,873669,874724,galactose-1-epimerase,1055
SARO_RS04095,Saro_0820,874729,874998,hypothetical protein,269
SARO_RS04100,Saro_0821,875100,876857,acyl-CoA synthetase,1757
SARO_RS04105,Saro_0822,876948,877616,hypothetical protein,668
SARO_RS04110,Saro_0823,877600,878097,DUF192 domain-containing protein,497
SARO_RS04115,Saro_0824,878184,878597,NADH:ubiquinone oxidoreductase subunit NDUFA12,413
SARO_RS04125,Saro_0826,879049,879840,leucyl/phenylalanyl-tRNA--protein transferase,791
SARO_RS04135,Saro_0827,880205,880684,nucleoside diphosphate kinase regulator,479
SARO_RS04140,NA,880677,880988,AsnC family transcriptional regulator,311
SARO_RS04145,Saro_0829,881069,881854,hypothetical protein,785
SARO_RS04150,Saro_0830,881925,882569,hypothetical protein,644
SARO_RS04155,Saro_0831,882900,883094,preprotein translocase subunit SecE,194
SARO_RS04160,Saro_0832,883127,883663,transcription termination/antitermination protein NusG,536
SARO_RS04165,Saro_0833,883820,884251,50S ribosomal protein L11,431
SARO_RS04170,Saro_0834,884256,884957,50S ribosomal protein L1,701
SARO_RS04175,Saro_0835,885047,885244,hypothetical protein,197
SARO_RS04180,Saro_0836,885225,885779,hypothetical protein,554
SARO_RS04185,Saro_0837,885781,886479,peptidylprolyl isomerase,698
SARO_RS04190,Saro_0838,886512,888626,DUF3857 domain-containing protein,2114
SARO_RS04195,Saro_0839,888663,889424,competence/damage-inducible protein A,761
SARO_RS04200,Saro_0840,889465,890988,NAD(P)/FAD-dependent oxidoreductase,1523
SARO_RS04205,Saro_0841,891079,892053,magnesium and cobalt transport protein CorA,974
SARO_RS04210,Saro_0842,892181,892828,DUF47 domain-containing protein,647
SARO_RS04215,Saro_0843,892853,893851,inorganic phosphate transporter,998
SARO_RS04220,Saro_0844,893966,895585,peptidase M28,1619
SARO_RS04225,Saro_0845,895720,897009,DUF3391 domain-containing protein,1289
SARO_RS04230,Saro_0846,897013,898428,30S ribosomal protein S12 methylthiotransferase RimO,1415
SARO_RS04235,Saro_0847,898533,898943,DUF1761 domain-containing protein,410
SARO_RS04240,Saro_0848,898940,899983,potassium transporter TrkA,1043
SARO_RS04245,Saro_0849,899983,900738,M23 family peptidase,755
SARO_RS04250,Saro_0850,900738,902018,serine--tRNA ligase,1280
SARO_RS04255,Saro_0851,902064,902255,DUF2892 domain-containing protein,191
SARO_RS04260,Saro_0852,902522,904303,methyl-accepting chemotaxis protein,1781
SARO_RS04270,Saro_0853,904571,904870,DUF3297 domain-containing protein,299
SARO_RS04275,Saro_0854,904919,905815,LysR family transcriptional regulator,896
SARO_RS04280,Saro_0855,905920,907416,methylmalonate-semialdehyde dehydrogenase (CoA acylating),1496
SARO_RS04285,Saro_0856,907491,907985,hypothetical protein,494
SARO_RS04290,Saro_0857,908006,908311,hypothetical protein,305
SARO_RS04295,Saro_0858,908398,909540,acyl-CoA dehydrogenase,1142
SARO_RS04300,Saro_0859,909537,910583,enoyl-CoA hydratase/isomerase family protein,1046
SARO_RS04305,Saro_0860,910697,911482,enoyl-CoA hydratase,785
SARO_RS04310,Saro_0861,911487,912356,3-hydroxyisobutyrate dehydrogenase,869
SARO_RS20130,Saro_0862,912404,913141,CHAP domain-containing protein,737
SARO_RS04320,Saro_0863,913308,914693,ribosome biogenesis GTPase Der,1385
SARO_RS04325,Saro_0864,914694,916976,TonB-dependent receptor,2282
SARO_RS04330,Saro_0865,917069,917890,hypothetical protein,821
SARO_RS04335,Saro_0866,917991,920645,hypothetical protein,2654
SARO_RS04340,Saro_0867,920716,921891,acetyl-CoA C-acyltransferase,1175
SARO_RS04345,Saro_0868,921894,923498,4-coumarate--CoA ligase,1604
SARO_RS04350,Saro_0869,923513,924769,3-hydroxyacyl-CoA dehydrogenase,1256
SARO_RS04355,Saro_0870,924792,926024,serine hydrolase,1232
SARO_RS04360,Saro_0871,926038,926886,thioesterase family protein,848
SARO_RS04365,Saro_0872,927106,928386,MFS transporter,1280
SARO_RS04370,Saro_0873,928492,929379,LysR family transcriptional regulator,887
SARO_RS04375,Saro_0874,929478,930590,S-(hydroxymethyl)glutathione dehydrogenase/class III alcohol dehydrogenase,1112
SARO_RS04380,Saro_0875,930813,931592,3-oxoacyl-ACP reductase,779
SARO_RS04385,Saro_0876,931664,932206,NUDIX hydrolase,542
SARO_RS04390,Saro_0877,932203,932886,membrane protein,683
SARO_RS04395,Saro_0878,932898,933737,TPM domain-containing protein,839
SARO_RS04400,Saro_0879,933739,934365,LemA family protein,626
SARO_RS04405,Saro_0880,934548,934988,large conductance mechanosensitive channel protein MscL,440
SARO_RS04410,Saro_0881,935440,935685,membrane protein,245
SARO_RS04415,Saro_0882,935831,937096,succinylarginine dihydrolase,1265
SARO_RS04420,Saro_0883,937249,938286,arginine N-succinyltransferase,1037
SARO_RS04425,Saro_0884,938283,939491,hypothetical protein,1208
SARO_RS04430,Saro_0885,939734,941863,malate synthase G,2129
SARO_RS04435,Saro_0886,941886,942707,ribosomal RNA small subunit methyltransferase A,821
SARO_RS04440,Saro_0887,942704,943711,4-hydroxythreonine-4-phosphate dehydrogenase PdxA,1007
SARO_RS04445,Saro_0888,943788,945158,peptidyl-prolyl cis-trans isomerase,1370
SARO_RS04450,Saro_0889,945287,947557,LPS-assembly protein LptD,2270
SARO_RS04455,Saro_0890,947659,949116,leucyl aminopeptidase,1457
SARO_RS20560,Saro_0891,949181,949333,DUF2256 domain-containing protein,152
SARO_RS04460,Saro_0892,949333,949764,DNA polymerase III subunit chi,431
SARO_RS04465,Saro_0893,949958,950257,excinuclease ABC subunit C,299
SARO_RS04470,Saro_0894,950467,950889,nucleoside-diphosphate kinase,422
SARO_RS04475,Saro_0895,951145,953454,TonB-dependent receptor,2309
SARO_RS04480,Saro_0896,953540,953791,hypothetical protein,251
SARO_RS04485,Saro_0897,953832,954965,hypothetical protein,1133
SARO_RS04490,Saro_0898,954970,955557,phosphoribosylglycinamide formyltransferase,587
SARO_RS04495,Saro_0899,955550,956656,phosphoribosylformylglycinamidine cyclo-ligase,1106
SARO_RS04500,Saro_0900,956793,958061,hypothetical protein,1268
SARO_RS04505,Saro_0901,958095,958709,ATPase,614
SARO_RS04510,Saro_0902,958737,959459,serine acetyltransferase,722
SARO_RS04515,Saro_0903,959495,959827,DUF2794 domain-containing protein,332
SARO_RS04520,Saro_0904,959841,960254,PaaI family thioesterase,413
SARO_RS04525,Saro_0905,960251,960754,PaaI family thioesterase,503
SARO_RS04530,Saro_0906,960808,961275,Holliday junction resolvase RuvX,467
SARO_RS04535,Saro_0907,961272,962387,DUF3089 domain-containing protein,1115
SARO_RS04540,Saro_0908,962391,963458,AI-2E family transporter,1067
SARO_RS04545,Saro_0909,963464,964270,signal peptidase I,806
SARO_RS04550,Saro_0910,964366,964785,holo-ACP synthase,419
SARO_RS04555,Saro_0911,964782,965525,pyridoxine 5'-phosphate synthase,743
SARO_RS04560,Saro_0912,965522,966106,orotate phosphoribosyltransferase,584
SARO_RS04565,Saro_0913,966325,967434,cytochrome c oxidase subunit II,1109
SARO_RS04570,Saro_0914,967462,969150,cytochrome c oxidase subunit I,1688
SARO_RS04575,Saro_0915,969351,970265,protoheme IX farnesyltransferase,914
SARO_RS04580,Saro_0917,970439,971068,cytochrome c oxidase assembly protein,629
SARO_RS04585,Saro_0918,971151,971972,cytochrome c oxidase subunit 3,821
SARO_RS20565,Saro_0919,971972,972343,DUF983 domain-containing protein,371
SARO_RS04595,Saro_0920,972343,972927,SURF1 family protein,584
SARO_RS04600,Saro_0921,973079,974500,threonine synthase,1421
SARO_RS04605,Saro_0922,974493,975377,SAM-dependent methyltransferase,884
SARO_RS04610,Saro_0923,975431,975805,dihydroneopterin aldolase,374
SARO_RS04615,Saro_0924,975805,976563,KR domain-containing protein,758
SARO_RS04620,Saro_0925,976560,977579,GTP 3'%2C8-cyclase MoaA,1019
SARO_RS04625,Saro_0926,977579,977815,thiamine biosynthesis protein ThiS,236
SARO_RS04630,Saro_0927,977817,978263,molybdopterin converting factor,446
SARO_RS20140,Saro_0928,978281,978910,hypothetical protein,629
SARO_RS04640,Saro_0929,979072,979368,50S ribosomal protein L21,296
SARO_RS04645,Saro_0930,979395,979664,50S ribosomal protein L27,269
SARO_RS04650,Saro_0931,979898,980467,N-acetyltransferase,569
SARO_RS04655,Saro_0932,980516,981400,metal-dependent hydrolase,884
SARO_RS04660,Saro_0933,981438,982028,TetR/AcrR family transcriptional regulator,590
SARO_RS04665,Saro_0934,982012,982758,folate-binding protein,746
SARO_RS04670,Saro_0935,982797,983837,dihydroorotase,1040
SARO_RS04675,Saro_0936,983841,984728,EamA family transporter RarD,887
SARO_RS04680,Saro_0937,984937,985431,glycine zipper 2TM domain-containing protein,494
SARO_RS04685,Saro_0938,985557,985784,hypothetical protein,227
SARO_RS04690,Saro_0939,985781,987196,N-succinylglutamate 5-semialdehyde dehydrogenase,1415
SARO_RS04695,Saro_0940,987315,988724,YdiU family protein,1409
SARO_RS04700,Saro_0941,988797,989651,alpha/beta hydrolase,854
SARO_RS04705,Saro_0942,989648,990808,glycosyl transferase family 1,1160
SARO_RS04710,Saro_0943,990938,991699,hypothetical protein,761
SARO_RS04715,Saro_0944,991721,993067,pyrrolo-quinoline quinone,1346
SARO_RS04720,Saro_0945,993110,994444,protein-S-isoprenylcysteine methyltransferase,1334
SARO_RS04725,Saro_0946,994592,994792,hypothetical protein,200
SARO_RS04730,Saro_0947,994818,995099,hypothetical protein,281
SARO_RS04735,Saro_0948,995096,995395,antibiotic biosynthesis monooxygenase,299
SARO_RS04740,Saro_0949,995490,996863,glutamate--cysteine ligase,1373
SARO_RS04745,Saro_0950,996954,997703,16S rRNA (uracil(1498)-N(3))-methyltransferase,749
SARO_RS04750,Saro_0951,997752,998666,4-hydroxybenzoate octaprenyltransferase,914
SARO_RS20145,Saro_0952,998645,999553,hypothetical protein,908
SARO_RS04760,Saro_0953,999480,999857,VOC family protein,377
SARO_RS04765,Saro_0954,1000009,1000449,redox-sensitive transcriptional activator SoxR,440
SARO_RS04770,Saro_0955,1000446,1003886,chromosome segregation protein SMC,3440
SARO_RS04775,Saro_0956,1003928,1004677,protein disulfide-isomerase,749
SARO_RS04780,Saro_0957,1005022,1005348,excinuclease ABC subunit C,326
SARO_RS04785,Saro_0958,1005560,1006276,protein disulfide-isomerase,716
SARO_RS04790,Saro_0959,1006273,1006842,DUF721 domain-containing protein,569
SARO_RS04795,Saro_0960,1006872,1007951,A/G-specific adenine glycosylase,1079
SARO_RS04800,Saro_0961,1007956,1009251,serine hydrolase,1295
SARO_RS04805,Saro_0962,1009248,1010132,NAD(+) diphosphatase,884
SARO_RS04810,Saro_0963,1010129,1010821,DsbA family oxidoreductase,692
SARO_RS04815,Saro_0964,1010832,1011239,DUF1489 domain-containing protein,407
SARO_RS04820,Saro_0965,1011254,1012699,magnesium transporter,1445
SARO_RS04825,Saro_0966,1012810,1013265,peptidylprolyl isomerase,455
SARO_RS04830,Saro_0967,1013326,1014654,glutamate--tRNA ligase 1,1328
SARO_RS04835,Saro_0968,1014694,1015128,hypothetical protein,434
SARO_RS04840,Saro_0969,1015181,1015429,hypothetical protein,248
SARO_RS04845,Saro_0970,1015433,1017100,NAD+ synthase,1667
SARO_RS04850,Saro_0971,1017201,1018136,ribose-phosphate pyrophosphokinase,935
SARO_RS04855,Saro_0972,1018189,1018677,polyketide cyclase,488
SARO_RS04860,Saro_0973,1018762,1019349,TetR/AcrR family transcriptional regulator,587
SARO_RS04865,Saro_0974,1019333,1020274,AraC family transcriptional regulator,941
SARO_RS04870,Saro_0975,1020437,1021216,histidinol phosphate phosphatase,779
SARO_RS04875,Saro_0976,1021224,1021673,gamma-glutamylcyclotransferase,449
SARO_RS04880,Saro_0977,1021670,1022071,hypothetical protein,401
SARO_RS04885,Saro_0978,1022068,1022949,LysR family transcriptional regulator,881
SARO_RS04890,Saro_0979,1022952,1023893,HlyC/CorC family transporter,941
SARO_RS04895,Saro_0980,1023914,1024417,endoribonuclease YbeY,503
SARO_RS04900,Saro_0981,1024414,1025460,PhoH family protein,1046
SARO_RS04905,Saro_0982,1025606,1026937,tRNA (N6-isopentenyl adenosine(37)-C2)-methylthiotransferase MiaB,1331
SARO_RS04910,Saro_0983,1026972,1027664,1-acyl-sn-glycerol-3-phosphate acyltransferase,692
SARO_RS04915,Saro_0984,1027729,1028151,transcriptional repressor,422
SARO_RS04920,Saro_0985,1028255,1028692,MucR family transcriptional regulator,437
SARO_RS04925,Saro_0986,1028861,1029334,GNAT family N-acetyltransferase,473
SARO_RS04930,Saro_0987,1029346,1029966,tRNA (adenosine(37)-N6)-threonylcarbamoyltransferase complex dimerization subunit type 1 TsaB,620
SARO_RS04935,Saro_0988,1029983,1030561,NifU family protein,578
SARO_RS04940,Saro_0989,1030696,1031259,FKBP-type peptidyl-prolyl cis-trans isomerase,563
SARO_RS04945,Saro_0990,1031323,1034208,insulinase family protein,2885
SARO_RS04950,Saro_0991,1034325,1035698,3-deoxy-7-phosphoheptulonate synthase class II,1373
SARO_RS20150,Saro_0992,1035736,1036329,TetR/AcrR family transcriptional regulator,593
SARO_RS20570,NA,1036335,1036994,cupin domain-containing protein,659
SARO_RS04965,Saro_0994,1036891,1037967,phosphotransferase family protein,1076
SARO_RS04970,Saro_0995,1037964,1039052,alcohol dehydrogenase,1088
SARO_RS04975,Saro_0996,1039072,1040364,acyl-CoA dehydrogenase,1292
SARO_RS04980,Saro_0997,1040458,1041885,Na+/melibiose symporter,1427
SARO_RS04985,Saro_0998,1041882,1042730,NAD(P)-dependent oxidoreductase,848
SARO_RS04990,Saro_0999,1042925,1044085,acyl-CoA dehydrogenase,1160
SARO_RS04995,Saro_1000,1044089,1045228,acyl-CoA dehydrogenase,1139
SARO_RS05000,Saro_1001,1045340,1046143,KR domain-containing protein,803
SARO_RS05005,Saro_1002,1046149,1047036,gluconolactonase,887
SARO_RS05010,Saro_1003,1047044,1047709,guanylate kinase,665
SARO_RS05015,Saro_1004,1047777,1048169,hypothetical protein,392
SARO_RS05020,Saro_1005,1048204,1048704,hypothetical protein,500
SARO_RS05025,Saro_1006,1048789,1049382,imidazoleglycerol-phosphate dehydratase,593
SARO_RS05030,Saro_1007,1049375,1050004,imidazole glycerol phosphate synthase subunit HisH,629
SARO_RS05035,Saro_1008,1050070,1051209,glycosidase,1139
SARO_RS05040,Saro_1009,1051232,1051957,1-(5-phosphoribosyl)-5-((5-phosphoribosylamino)methylideneamino)imidazole-4-carboxamide isomerase,725
SARO_RS05045,Saro_1010,1051962,1052735,imidazole glycerol phosphate synthase subunit HisF,773
SARO_RS05050,Saro_1011,1053185,1053508,phosphoribosyl-ATP pyrophosphatase,323
SARO_RS05055,Saro_1012,1053510,1053887,histidine triad nucleotide-binding protein,377
SARO_RS05060,Saro_1013,1053963,1054427,thioesterase,464
SARO_RS05065,Saro_1014,1054424,1055125,protein TolQ,701
SARO_RS05070,Saro_1015,1055135,1055581,biopolymer transporter ExbD,446
SARO_RS05075,Saro_1016,1055592,1056473,hypothetical protein,881
SARO_RS05080,Saro_1017,1056470,1057855,protein TolB 2,1385
SARO_RS05085,Saro_1018,1057969,1058481,peptidoglycan-associated lipoprotein Pal,512
SARO_RS05090,Saro_1019,1058602,1059135,molecular chaperone DnaJ,533
SARO_RS05095,Saro_1020,1059123,1060022,hypothetical protein,899
SARO_RS05100,Saro_1021,1059940,1061142,CCA tRNA nucleotidyltransferase,1202
SARO_RS05105,Saro_1022,1061135,1061749,CoA pyrophosphatase,614
SARO_RS05110,Saro_1023,1061746,1062315,DUF1285 domain-containing protein,569
SARO_RS05115,Saro_1024,1062338,1062847,N-acetyltransferase,509
SARO_RS05120,Saro_1025,1063077,1064498,cytochrome ubiquinol oxidase subunit I,1421
SARO_RS05125,Saro_1026,1064498,1065496,cytochrome d ubiquinol oxidase subunit II,998
SARO_RS20575,Saro_1027,1065483,1065644,DUF2474 domain-containing protein,161
SARO_RS05130,Saro_1028,1065625,1067019,helix-turn-helix domain-containing protein,1394
SARO_RS05135,Saro_1029,1067166,1068761,isocitrate lyase,1595
SARO_RS05140,Saro_1031,1069183,1071492,GGDEF domain-containing protein,2309
SARO_RS05145,Saro_1032,1071489,1072166,phosphoribosylformylglycinamidine synthase subunit PurQ,677
SARO_RS05150,Saro_1033,1072181,1072414,phosphoribosylformylglycinamidine synthase subunit PurS,233
SARO_RS05155,Saro_1034,1072837,1073451,TetR family transcriptional regulator,614
SARO_RS05160,Saro_1035,1073388,1074422,hypothetical protein,1034
SARO_RS05165,Saro_1036,1074419,1075405,ABC transporter ATP-binding protein,986
SARO_RS05170,Saro_1037,1075402,1076550,ABC transporter permease,1148
SARO_RS05175,Saro_1038,1076575,1079421,insulinase family protein,2846
SARO_RS05180,Saro_1039,1079480,1079674,hypothetical protein,194
SARO_RS05185,Saro_1040,1079674,1079976,hypothetical protein,302
SARO_RS05190,Saro_1041,1080291,1081076,phosphoribosylaminoimidazolesuccinocarboxamide synthase,785
SARO_RS05195,Saro_1042,1081361,1081786,hypothetical protein,425
SARO_RS05200,Saro_1043,1081783,1082370,N-acetyltransferase,587
SARO_RS05205,Saro_1044,1082364,1083260,amidohydrolase,896
SARO_RS05210,Saro_1045,1083306,1085522,MFS transporter,2216
SARO_RS05215,Saro_1046,1085515,1086528,acyl carrier protein,1013
SARO_RS05220,Saro_1047,1086525,1086989,low molecular weight phosphotyrosine protein phosphatase,464
SARO_RS05225,Saro_1048,1087170,1087943,DeoR/GlpR transcriptional regulator,773
SARO_RS05230,Saro_1049,1088007,1089080,L-rhamnose/proton symporter RhaT,1073
SARO_RS05235,Saro_1050,1089104,1090249,alpha-hydroxy-acid oxidizing protein,1145
SARO_RS05240,Saro_1051,1090260,1091609,carbohydrate kinase,1349
SARO_RS05245,Saro_1052,1091834,1092763,hypothetical protein,929
SARO_RS05250,Saro_1053,1093114,1095501,TonB-dependent receptor,2387
SARO_RS05255,Saro_1054,1095516,1097246,amidohydrolase,1730
SARO_RS05265,Saro_1055,1097674,1097847,DNA gyrase inhibitor YacG,173
SARO_RS05270,Saro_1056,1097844,1098842,ribonuclease,998
SARO_RS05275,Saro_1057,1098832,1099437,maf-like protein,605
SARO_RS05280,Saro_1058,1099437,1099682,translation initiation factor IF-1,245
SARO_RS05285,Saro_1059,1100033,1102534,TonB-denpendent receptor,2501
SARO_RS05290,Saro_1060,1102730,1104667,excinuclease ABC subunit UvrC,1937
SARO_RS05295,Saro_1061,1104677,1105735,cysteine synthase,1058
SARO_RS05300,Saro_1062,1105871,1106659,hypothetical protein,788
SARO_RS05305,NA,1106656,1107108,hypothetical protein,452
SARO_RS05310,Saro_1064,1107109,1108011,acyl-CoA thioesterase II,902
SARO_RS05315,Saro_1065,1108056,1108937,transcriptional regulator,881
SARO_RS05320,Saro_1066,1108934,1110097,GNAT family N-acetyltransferase,1163
SARO_RS05325,Saro_1067,1110255,1112378,sodium-translocating pyrophosphatase,2123
SARO_RS05330,Saro_1068,1112500,1113561,thiamine-phosphate kinase,1061
SARO_RS05335,Saro_1069,1113487,1114659,acetyl-CoA C-acyltransferase,1172
SARO_RS05340,Saro_1070,1114693,1115478,3-hydroxy-2-methylbutyryl-CoA dehydrogenase,785
SARO_RS05345,Saro_1071,1115540,1116412,enoyl-CoA hydratase,872
SARO_RS05350,Saro_1072,1116409,1117047,TetR family transcriptional regulator,638
SARO_RS05355,Saro_1073,1117252,1117710,MarR family transcriptional regulator,458
SARO_RS05360,Saro_1074,1117707,1118714,FAA hydrolase family protein,1007
SARO_RS05365,Saro_1075,1118771,1119778,type II secretion system F family protein,1007
SARO_RS05370,Saro_1076,1119798,1120772,type II secretion system protein,974
SARO_RS05375,Saro_1077,1120816,1122090,pilus assembly protein CpaE,1274
SARO_RS05380,Saro_1078,1122095,1122766,hypothetical protein,671
SARO_RS05385,Saro_1079,1122781,1124400,BON domain-containing protein,1619
SARO_RS05390,Saro_1080,1124402,1125430,Flp pilus assembly protein CpaB,1028
SARO_RS05395,Saro_1081,1125506,1126006,peptidase,500
SARO_RS05400,Saro_1082,1126076,1127068,alpha/beta hydrolase,992
SARO_RS05405,Saro_1083,1127065,1128174,FAD-binding oxidoreductase,1109
SARO_RS05410,Saro_1084,1128266,1128448,DUF1508 domain-containing protein,182
SARO_RS05415,Saro_1085,1128544,1128975,ribonuclease H,431
SARO_RS05420,Saro_1086,1128972,1129958,homoserine kinase,986
SARO_RS05425,Saro_1087,1129961,1130929,4-hydroxy-3-methylbut-2-enyl diphosphate reductase,968
SARO_RS05430,Saro_1088,1131056,1131718,hypothetical protein,662
SARO_RS05435,Saro_1089,1131811,1133559,arginine--tRNA ligase,1748
SARO_RS05440,Saro_1090,1133585,1134334,hypothetical protein,749
SARO_RS05445,Saro_1091,1134481,1135497,beta-N-acetylhexosaminidase,1016
SARO_RS05450,Saro_1092,1135497,1136294,segregation/condensation protein A,797
SARO_RS05455,Saro_1093,1136291,1136938,SMC-Scp complex subunit ScpB,647
SARO_RS05460,Saro_1094,1137023,1137274,twin-arginine translocase TatA/TatE family subunit,251
SARO_RS05465,Saro_1095,1137301,1137729,twin-arginine translocase subunit TatB,428
SARO_RS05470,Saro_1096,1137726,1138565,twin-arginine translocase subunit TatC,839
SARO_RS05475,Saro_1097,1138736,1140442,metal-dependent hydrolase,1706
SARO_RS05480,Saro_1098,1140439,1141377,NAD(P)-dependent oxidoreductase,938
SARO_RS05485,NA,1141436,1141846,hypothetical protein,410
SARO_RS05490,Saro_1100,1141884,1143149,threonine ammonia-lyase,1265
SARO_RS05495,Saro_1101,1143360,1144214,arginyl-tRNA-protein transferase,854
SARO_RS05500,Saro_1102,1144285,1146414,outer membrane protein assembly factor,2129
SARO_RS05505,Saro_1103,1146414,1150610,translocation/assembly module TamB,4196
SARO_RS05510,Saro_1104,1150672,1152096,aldehyde dehydrogenase family protein,1424
SARO_RS05515,Saro_1106,1152536,1154830,bifunctional diguanylate cyclase/phosphodiesterase,2294
SARO_RS05520,Saro_1107,1154865,1155350,CHAP domain-containing protein,485
SARO_RS05525,Saro_1108,1155575,1156984,type I glutamate--ammonia ligase,1409
SARO_RS05530,Saro_1109,1157136,1157474,DUF3240 domain-containing protein,338
SARO_RS05535,Saro_1110,1157759,1158598,type I methionyl aminopeptidase,839
SARO_RS05540,Saro_1111,1158645,1159451,DUF3298/DUF4163 domain-containing protein,806
SARO_RS05545,Saro_1112,1159505,1160887,leucyl aminopeptidase family protein,1382
SARO_RS05550,Saro_1113,1161016,1161315,hypothetical protein,299
SARO_RS05555,Saro_1114,1161312,1162241,N-acetyl-gamma-glutamyl-phosphate reductase,929
SARO_RS05560,Saro_1115,1162325,1162642,ferredoxin,317
SARO_RS05565,Saro_1116,1162772,1163389,DNA-3-methyladenine glycosylase 2 family protein,617
SARO_RS05570,Saro_1117,1163430,1164230,short-chain dehydrogenase,800
SARO_RS05575,Saro_1118,1164233,1164523,pterin-4-alpha-carbinolamine dehydratase,290
SARO_RS05580,Saro_1119,1164585,1165160,cytochrome c biogenesis ATP-binding export protein CcmA,575
SARO_RS05585,Saro_1120,1165157,1165819,heme exporter protein CcmB,662
SARO_RS05590,Saro_1121,1165884,1166882,cysteine synthase A,998
SARO_RS05595,Saro_1122,1166897,1167280,hypothetical protein,383
SARO_RS05600,Saro_1123,1167283,1168020,hypothetical protein,737
SARO_RS05605,Saro_1124,1168272,1168838,division/cell wall cluster transcriptional repressor MraZ,566
SARO_RS05610,Saro_1125,1168835,1169824,ribosomal RNA small subunit methyltransferase H,989
SARO_RS05620,Saro_1127,1170678,1172423,penicillin-binding protein 2,1745
SARO_RS05625,Saro_1128,1172420,1173868,UDP-N-acetylmuramoyl-L-alanyl-D-glutamate--2%2C6-diaminopimelate ligase,1448
SARO_RS05630,Saro_1129,1173865,1175334,UDP-N-acetylmuramoylalanyl-D-glutamyl-2%2C 6-diaminopimelate--D-alanyl-D-alanine ligase,1469
SARO_RS05635,Saro_1130,1175335,1176399,phospho-N-acetylmuramoyl-pentapeptide-transferase,1064
SARO_RS05640,Saro_1131,1176396,1177727,UDP-N-acetylmuramoyl-L-alanine--D-glutamate ligase,1331
SARO_RS05645,Saro_1132,1177766,1178959,cell division protein FtsW,1193
SARO_RS05650,Saro_1133,1178956,1180122,undecaprenyldiphospho-muramoylpentapeptide beta-N- acetylglucosaminyltransferase,1166
SARO_RS05655,Saro_1134,1180119,1181543,UDP-N-acetylmuramate--L-alanine ligase,1424
SARO_RS05660,Saro_1135,1181540,1182433,UDP-N-acetylenolpyruvoylglucosamine reductase,893
SARO_RS05665,Saro_1136,1182477,1183418,D-alanine--D-alanine ligase,941
SARO_RS05670,Saro_1137,1183423,1184385,cell division protein FtsQ,962
SARO_RS05675,Saro_1138,1184393,1185673,cell division protein FtsA,1280
SARO_RS05680,Saro_1139,1185868,1187343,cell division protein FtsZ,1475
SARO_RS05685,Saro_1140,1187406,1189598,SPOR domain-containing protein,2192
SARO_RS05690,Saro_1141,1189801,1190304,hypothetical protein,503
SARO_RS05695,Saro_1142,1190387,1191196,pyrroline-5-carboxylate reductase,809
SARO_RS05700,Saro_1143,1191311,1192054,BAX inhibitor (BI)-1/YccA family protein,743
SARO_RS05705,Saro_1144,1192227,1192958,hypothetical protein,731
SARO_RS05715,Saro_1145,1193278,1194336,GTPase ObgE,1058
SARO_RS05720,Saro_1146,1194468,1195601,glutamate 5-kinase,1133
SARO_RS05725,Saro_1147,1195601,1196521,epimerase,920
SARO_RS05730,Saro_1148,1196622,1197038,DUF805 domain-containing protein,416
SARO_RS05735,Saro_1149,1197056,1197472,DUF805 domain-containing protein,416
SARO_RS05740,Saro_1150,1197469,1200012,ABC transporter permease,2543
SARO_RS05745,Saro_1151,1200009,1200701,ABC transporter,692
SARO_RS05750,Saro_1152,1200770,1201453,arylesterase,683
SARO_RS05755,Saro_1153,1201482,1202555,DNA replication and repair protein RecF,1073
SARO_RS05760,Saro_1154,1202640,1203665,phage shock protein operon transcriptional activator,1025
SARO_RS05765,Saro_1156,1203995,1204819,phage shock protein PspA,824
SARO_RS05770,Saro_1157,1204823,1205119,envelope stress response membrane protein PspB,296
SARO_RS05775,Saro_1158,1205116,1205490,envelope stress response membrane protein PspC,374
SARO_RS05780,Saro_1159,1205522,1205803,hypothetical protein,281
SARO_RS05785,Saro_1160,1205800,1206111,hypothetical protein,311
SARO_RS05790,Saro_1161,1206108,1206380,hypothetical protein,272
SARO_RS05795,Saro_1162,1206395,1206649,hypothetical protein,254
SARO_RS05800,Saro_1163,1206672,1206884,hypothetical protein,212
SARO_RS05805,Saro_1164,1206957,1207370,Fe-S metabolism protein SufE,413
SARO_RS05810,Saro_1165,1207388,1207738,DUF454 domain-containing protein,350
SARO_RS05815,Saro_1166,1207714,1208808,acyltransferase,1094
SARO_RS05820,Saro_1167,1208875,1209450,hypothetical protein,575
SARO_RS05825,Saro_1168,1209469,1209987,beta-carotene hydroxylase,518
SARO_RS05830,Saro_1169,1210124,1210504,hypothetical protein,380
SARO_RS05835,Saro_1170,1210614,1212050,3-isopropylmalate dehydratase large subunit,1436
SARO_RS05840,Saro_1171,1212058,1212588,hypothetical protein,530
SARO_RS05845,Saro_1172,1212585,1213091,DNA-deoxyinosine glycosylase,506
SARO_RS05850,Saro_1173,1213375,1213983,3-isopropylmalate dehydratase small subunit,608
SARO_RS05855,Saro_1174,1214075,1215076,NADPH:quinone oxidoreductase family protein,1001
SARO_RS05860,Saro_1175,1215126,1215764,trimeric intracellular cation channel family protein,638
SARO_RS05865,Saro_1176,1215757,1216803,nitronate monooxygenase,1046
SARO_RS05870,Saro_1177,1216809,1217006,hypothetical protein,197
SARO_RS05875,Saro_1178,1217118,1218518,dihydrolipoyl dehydrogenase,1400
SARO_RS05880,Saro_1179,1218600,1219826,dihydrolipoyllysine-residue succinyltransferase,1226
SARO_RS05885,Saro_1180,1219865,1222717,2-oxoglutarate dehydrogenase E1 component,2852
SARO_RS05890,Saro_1181,1222937,1223827,succinate--CoA ligase subunit alpha,890
SARO_RS05895,Saro_1182,1223941,1224903,malate dehydrogenase,962
SARO_RS05900,Saro_1183,1225225,1225536,hypothetical protein,311
SARO_RS05905,NA,1225715,1226416,endo alpha-1%2C4 polygalactosaminidase,701
SARO_RS05910,Saro_1185,1226780,1228009,cell wall hydrolase,1229
SARO_RS05915,Saro_1186,1228490,1230394,TonB-dependent receptor,1904
SARO_RS05920,NA,1230445,1231398,periplasmic binding protein,953
SARO_RS05925,Saro_1188,1231395,1232357,iron ABC transporter permease,962
SARO_RS05930,Saro_1189,1232357,1233088,ABC transporter ATP-binding protein,731
SARO_RS05935,NA,1233089,1233292,hypothetical protein,203
SARO_RS05940,Saro_1190,1233486,1234793,DUF560 domain-containing protein,1307
SARO_RS05945,Saro_1191,1234849,1235709,hypothetical protein,860
SARO_RS05950,Saro_1192,1235856,1238768,excinuclease ABC subunit UvrA,2912
SARO_RS05955,NA,1238854,1239360,hypothetical protein,506
SARO_RS20155,Saro_1194,1240311,1241567,CHRD domain-containing protein,1256
SARO_RS05970,Saro_1195,1242494,1243708,argininosuccinate synthase,1214
SARO_RS05975,Saro_1196,1243805,1245124,hypothetical protein,1319
SARO_RS05980,Saro_1197,1245211,1246557,aldehyde dehydrogenase,1346
SARO_RS05985,Saro_1198,1246715,1247386,phosphoglycolate phosphatase,671
SARO_RS05990,Saro_1199,1247448,1248821,bifunctional UDP-N-acetylglucosamine diphosphorylase/glucosamine-1-phosphate N-acetyltransferase GlmU,1373
SARO_RS05995,Saro_1200,1248898,1249146,CopG family transcriptional regulator,248
SARO_RS06000,Saro_1201,1249150,1249515,PIN domain-containing protein,365
SARO_RS06005,Saro_1202,1249534,1251357,glutamine--fructose-6-phosphate transaminase (isomerizing),1823
SARO_RS06010,Saro_1203,1251369,1251824,tRNA (cytidine(34)-2'-O)-methyltransferase,455
SARO_RS06020,Saro_1204,1252074,1252859,sulfite exporter TauE/SafE family protein,785
SARO_RS06025,Saro_1205,1252859,1253782,MBL fold metallo-hydrolase,923
SARO_RS06030,Saro_1206,1253908,1254222,transcriptional regulator,314
SARO_RS06035,Saro_1207,1254345,1254989,twin-arginine translocation pathway signal protein,644
SARO_RS06040,Saro_1208,1255008,1256687,GMC family oxidoreductase,1679
SARO_RS06045,Saro_1209,1256692,1258152,MFS transporter,1460
SARO_RS06050,Saro_1210,1258216,1258803,HD domain-containing protein,587
SARO_RS06055,Saro_1211,1258874,1260457,fatty acid--CoA ligase,1583
SARO_RS20160,Saro_1212,1260614,1261603,DUF4402 domain-containing protein,989
SARO_RS06065,Saro_1213,1261600,1264326,hypothetical protein,2726
SARO_RS06070,Saro_1214,1264328,1265212,hypothetical protein,884
SARO_RS06075,Saro_1215,1265224,1265649,hypothetical protein,425
SARO_RS06080,Saro_1216,1265710,1266237,DUF4402 domain-containing protein,527
SARO_RS06085,Saro_1217,1266836,1267111,HU family DNA-binding protein,275
SARO_RS06090,Saro_1218,1267442,1268650,efflux RND transporter periplasmic adaptor subunit,1208
SARO_RS06095,Saro_1219,1268657,1271791,multidrug efflux RND transporter permease subunit,3134
SARO_RS06100,Saro_1220,1271788,1273191,RND transporter,1403
SARO_RS06105,Saro_1221,1273185,1274351,acyl-CoA dehydrogenase,1166
SARO_RS06110,Saro_1222,1274354,1275568,acetyl-CoA C-acyltransferase,1214
SARO_RS06115,Saro_1223,1275620,1276849,L-carnitine dehydratase,1229
SARO_RS06120,Saro_1224,1276877,1278061,acyl-CoA dehydrogenase,1184
SARO_RS06125,Saro_1225,1278073,1278990,KR domain-containing protein,917
SARO_RS06130,Saro_1226,1279093,1279842,IclR family transcriptional regulator,749
SARO_RS06135,Saro_1227,1279961,1280869,LysR family transcriptional regulator,908
SARO_RS06140,Saro_1228,1280878,1281339,PaaI family thioesterase,461
SARO_RS06145,Saro_1229,1281400,1282368,FAD-dependent oxidoreductase,968
SARO_RS06150,Saro_1230,1282400,1282996,GTP cyclohydrolase I FolE,596
SARO_RS06155,Saro_1231,1283176,1283751,PAS domain-containing protein,575
SARO_RS06160,NA,1283767,1284681,sensor histidine kinase,914
SARO_RS06165,NA,1284926,1285297,hypothetical protein,371
SARO_RS06170,NA,1285483,1285884,protocatechuate 3%2C4-dioxygenase,401
SARO_RS06175,Saro_1234,1285884,1286726,protocatechuate 3%2C4-dioxygenase subunit beta,842
SARO_RS06180,Saro_1235,1286812,1287213,hypothetical protein,401
SARO_RS06185,Saro_1236,1287299,1287925,DNA-binding response regulator,626
SARO_RS06190,Saro_1237,1287922,1289529,sensor histidine kinase,1607
SARO_RS06195,Saro_1238,1289802,1290305,LuxR family transcriptional regulator,503
SARO_RS06205,Saro_1240,1290802,1291248,hypothetical protein,446
SARO_RS06210,NA,1291310,1291828,MarR family transcriptional regulator,518
SARO_RS06215,NA,1291870,1292307,energy transducer TonB,437
SARO_RS20165,NA,1292291,1292533,hypothetical protein,242
SARO_RS06220,NA,1292818,1293135,hypothetical protein,317
SARO_RS06225,Saro_1244,1293513,1293884,30S ribosomal protein S12,371
SARO_RS06230,Saro_1245,1293986,1294456,30S ribosomal protein S7,470
SARO_RS06235,Saro_1246,1294541,1296613,elongation factor G,2072
SARO_RS06240,Saro_1247,1296706,1297896,elongation factor Tu,1190
SARO_RS06245,Saro_1248,1298066,1298377,30S ribosomal protein S10,311
SARO_RS06250,Saro_1249,1298719,1299474,50S ribosomal protein L3,755
SARO_RS06255,Saro_1250,1299478,1300101,50S ribosomal protein L4,623
SARO_RS06260,Saro_1251,1300094,1300396,50S ribosomal protein L23,302
SARO_RS06265,Saro_1252,1300406,1301242,50S ribosomal protein L2,836
SARO_RS06270,Saro_1253,1301249,1301527,30S ribosomal protein S19,278
SARO_RS06275,Saro_1254,1301527,1301904,50S ribosomal protein L22,377
SARO_RS06280,Saro_1255,1301907,1302602,30S ribosomal protein S3,695
SARO_RS06285,Saro_1256,1302625,1303059,50S ribosomal protein L16,434
SARO_RS06290,Saro_1257,1303070,1303276,50S ribosomal protein L29,206
SARO_RS06295,Saro_1258,1303287,1303556,30S ribosomal protein S17,269
SARO_RS06300,Saro_1259,1303671,1304039,50S ribosomal protein L14,368
SARO_RS06305,Saro_1260,1304039,1304356,50S ribosomal protein L24,317
SARO_RS06310,Saro_1261,1304349,1304930,50S ribosomal protein L5,581
SARO_RS06315,Saro_1262,1304959,1305264,30S ribosomal protein S14,305
SARO_RS06320,Saro_1263,1305275,1305670,30S ribosomal protein S8,395
SARO_RS06325,Saro_1264,1305670,1306203,50S ribosomal protein L6,533
SARO_RS06330,Saro_1265,1306203,1306553,50S ribosomal protein L18,350
SARO_RS06335,Saro_1266,1306556,1307269,30S ribosomal protein S5,713
SARO_RS06340,Saro_1267,1307276,1307452,50S ribosomal protein L30,176
SARO_RS06345,Saro_1268,1307618,1308133,50S ribosomal protein L15,515
SARO_RS06350,Saro_1269,1308286,1309653,preprotein translocase subunit SecY,1367
SARO_RS06355,Saro_1270,1309682,1310332,adenylate kinase,650
SARO_RS06360,Saro_1271,1310380,1311117,hypothetical protein,737
SARO_RS06365,Saro_1272,1311265,1312620,NADP-specific glutamate dehydrogenase,1355
SARO_RS06370,Saro_1273,1312675,1313022,hypothetical protein,347
SARO_RS06375,Saro_1274,1313066,1313875,DNA-binding response regulator,809
SARO_RS06380,Saro_1275,1314279,1315349,recombinase RecA,1070
SARO_RS06385,Saro_1276,1315537,1316163,glutathione S-transferase,626
SARO_RS06390,Saro_1277,1316192,1318252,elongation factor G,2060
SARO_RS06395,Saro_1278,1318409,1319236,methyltransferase domain-containing protein,827
SARO_RS06400,Saro_1279,1319280,1321925,alanine--tRNA ligase,2645
SARO_RS06405,Saro_1281,1322145,1323929,sodium/hydrogen exchanger,1784
SARO_RS06410,Saro_1282,1324213,1325436,isocitrate dehydrogenase (NADP(+)),1223
SARO_RS06415,Saro_1283,1325623,1326387,enoyl-CoA hydratase,764
SARO_RS06420,Saro_1284,1326432,1327220,3-deoxy-manno-octulosonate cytidylyltransferase,788
SARO_RS06425,Saro_1285,1327217,1328431,capsular polysaccharide biosynthesis protein,1214
SARO_RS06430,Saro_1286,1328422,1329735,capsule polysaccharide biosynthesis,1313
SARO_RS06440,Saro_1287,1330047,1330430,response regulator,383
SARO_RS06445,Saro_1288,1330582,1331544,N-formylglutamate amidohydrolase,962
SARO_RS06450,Saro_1289,1331879,1332658,multidrug transporter,779
SARO_RS06455,Saro_1290,1332757,1334175,FAD-binding oxidoreductase,1418
SARO_RS06460,Saro_1291,1334341,1334913,hypothetical protein,572
SARO_RS06465,Saro_1292,1335055,1336449,ATP-dependent helicase,1394
SARO_RS06470,Saro_1293,1336587,1338884,DNA helicase II,2297
SARO_RS06475,Saro_1294,1339044,1339685,hypothetical protein,641
SARO_RS06480,Saro_1295,1339901,1341172,MFS transporter,1271
SARO_RS06485,Saro_1296,1341179,1341721,16S rRNA (guanine(966)-N(2))-methyltransferase RsmD,542
SARO_RS06490,Saro_1297,1341718,1342602,ribosomal large subunit pseudouridine synthase B,884
SARO_RS06495,Saro_1298,1342714,1344042,MFS transporter,1328
SARO_RS06500,Saro_1299,1344074,1345381,bifunctional folylpolyglutamate synthase/dihydrofolate synthase,1307
SARO_RS06505,Saro_1300,1345413,1346264,acetyl-CoA carboxylase carboxyl transferase subunit beta,851
SARO_RS06510,Saro_1301,1346261,1347061,tryptophan synthase subunit alpha,800
SARO_RS06515,Saro_1302,1347061,1348275,tryptophan synthase subunit beta,1214
SARO_RS06520,Saro_1303,1348647,1349204,porin family protein,557
SARO_RS06525,Saro_1304,1349308,1349997,phosphoribosylanthranilate isomerase,689
SARO_RS06530,Saro_1305,1350010,1350765,SIMPL domain-containing protein,755
SARO_RS06535,Saro_1306,1350835,1351335,N-acetyltransferase,500
SARO_RS06540,Saro_1307,1351343,1352017,orotidine-5'-phosphate decarboxylase,674
SARO_RS06545,Saro_1308,1352014,1352343,DUF1049 domain-containing protein,329
SARO_RS06550,Saro_1309,1352436,1353752,adenylosuccinate lyase,1316
SARO_RS20170,Saro_1310,1353867,1355732,acyltransferase,1865
SARO_RS20580,NA,1355903,1356028,entericidin%2C EcnA/B family,125
SARO_RS06560,Saro_1311,1356054,1356791,DNA repair protein RadC,737
SARO_RS06565,Saro_1312,1356877,1360107,hypothetical protein,3230
SARO_RS06570,Saro_1313,1360155,1360361,YnbE family lipoprotein,206
SARO_RS06575,Saro_1314,1360406,1360789,DUF1318 domain-containing protein,383
SARO_RS06580,Saro_1315,1360997,1361317,F0F1 ATP synthase assembly protein I,320
SARO_RS06585,Saro_1316,1361358,1362140,ATP synthase subunit A,782
SARO_RS06590,Saro_1317,1362189,1362416,F0F1 ATP synthase subunit C,227
SARO_RS06595,Saro_1318,1362491,1362985,H+-transporting two-sector ATPase subunit B/B',494
SARO_RS06600,Saro_1319,1362978,1363532,ATP synthase subunit B,554
SARO_RS06605,Saro_1320,1363722,1364708,LacI family transcriptional regulator,986
SARO_RS06610,Saro_1321,1364792,1365556,hydroxyacylglutathione hydrolase,764
SARO_RS06615,Saro_1322,1365649,1367349,30S ribosomal protein S1,1700
SARO_RS06620,Saro_1324,1368133,1368759,(d)CMP kinase,626
SARO_RS06625,Saro_1325,1368756,1369010,hypothetical protein,254
SARO_RS06630,Saro_1326,1369010,1370335,3-phosphoshikimate 1-carboxyvinyltransferase,1325
SARO_RS06635,Saro_1327,1370546,1370863,TIGR02300 family protein,317
SARO_RS06645,Saro_1328,1371271,1371876,hypothetical protein,605
SARO_RS06650,Saro_1329,1371876,1372580,hypothetical protein,704
SARO_RS06655,Saro_1330,1372662,1373597,isopenicillin N synthase family oxygenase,935
SARO_RS06660,Saro_1331,1373662,1374105,EVE domain-containing protein,443
SARO_RS06665,Saro_1332,1374166,1374348,CsbD family protein,182
SARO_RS06670,NA,1374493,1374774,hypothetical protein,281
SARO_RS06675,Saro_1334,1374764,1376086,MFS transporter,1322
SARO_RS06680,Saro_1335,1376224,1376817,CDP-diacylglycerol--glycerol-3-phosphate 3-phosphatidyltransferase,593
SARO_RS06685,Saro_1336,1376843,1377739,hydrogen peroxide-inducible genes activator,896
SARO_RS06690,Saro_1337,1377746,1378963,ribonuclease D,1217
SARO_RS06695,Saro_1338,1379139,1380920,aspartate--tRNA(Asp/Asn) ligase,1781
SARO_RS06700,Saro_1339,1381048,1381284,acyl carrier protein,236
SARO_RS06705,Saro_1340,1381416,1382678,beta-ketoacyl-[acyl-carrier-protein] synthase II,1262
SARO_RS06710,Saro_1341,1382689,1383666,endolytic transglycosylase MltG,977
SARO_RS06715,Saro_1342,1383792,1384439,hypothetical protein,647
SARO_RS06720,Saro_1343,1384495,1385775,adenosylmethionine--8-amino-7-oxononanoate transaminase,1280
SARO_RS20175,Saro_1344,1386230,1388293,hypothetical protein,2063
SARO_RS06735,Saro_1345,1388322,1389089,CPBP family intramembrane metalloprotease,767
SARO_RS06740,Saro_1346,1389434,1389961,(2Fe-2S)-binding protein,527
SARO_RS06745,Saro_1347,1389958,1392267,twin-arginine translocation pathway signal protein,2309
SARO_RS06750,Saro_1348,1392290,1394167,ABC transporter ATP-binding protein,1877
SARO_RS06760,Saro_1349,1394446,1395423,WalW protein,977
SARO_RS06765,Saro_1350,1395459,1397264,sensor histidine kinase,1805
SARO_RS06770,Saro_1351,1397513,1397980,Lrp/AsnC family transcriptional regulator,467
SARO_RS06775,Saro_1352,1398014,1398304,chorismate mutase,290
SARO_RS06780,Saro_1353,1398395,1399408,polyprenyl synthetase family protein,1013
SARO_RS06785,Saro_1354,1399440,1400456,aldo/keto reductase,1016
SARO_RS06790,Saro_1355,1400714,1403167,ATP-dependent helicase HrpB,2453
SARO_RS06795,Saro_1356,1403216,1403494,ETC complex I subunit region,278
SARO_RS06800,Saro_1357,1403760,1405649,DNA polymerase III subunit gamma/tau,1889
SARO_RS06805,Saro_1358,1405646,1405981,nucleoid-associated protein%2C YbaB/EbfC family,335
SARO_RS06810,Saro_1359,1406339,1407109,hypothetical protein,770
SARO_RS06815,Saro_1360,1407116,1408129,hypothetical protein,1013
SARO_RS06820,Saro_1361,1408383,1410788,endopeptidase La,2405
SARO_RS06825,Saro_1362,1410990,1411262,HU family DNA-binding protein,272
SARO_RS06830,Saro_1363,1411377,1412237,hypothetical protein,860
SARO_RS06835,Saro_1364,1412258,1413073,23S rRNA (guanosine(2251)-2'-O)-methyltransferase RlmB,815
SARO_RS06845,Saro_1365,1413413,1414267,alpha/beta hydrolase,854
SARO_RS06850,Saro_1366,1414316,1415065,phosphatidylserine decarboxylase family protein,749
SARO_RS06855,Saro_1367,1415131,1415904,phosphatidylcholine/phosphatidylserine synthase,773
SARO_RS06860,Saro_1368,1415852,1416130,hypothetical protein,278
SARO_RS06865,Saro_1369,1416528,1417283,30S ribosomal protein S2,755
SARO_RS06870,Saro_1370,1417409,1418335,elongation factor Ts,926
SARO_RS06875,Saro_1371,1418481,1419215,UMP kinase,734
SARO_RS06880,Saro_1372,1419217,1419774,ribosome-recycling factor,557
SARO_RS06885,Saro_1373,1419771,1420481,di-trans%2Cpoly-cis-decaprenylcistransferase,710
SARO_RS06890,Saro_1374,1420372,1421217,hypothetical protein,845
SARO_RS06895,Saro_1375,1421222,1422379,1-deoxy-D-xylulose-5-phosphate reductoisomerase,1157
SARO_RS06900,Saro_1376,1422432,1423514,RIP metalloprotease RseP,1082
SARO_RS06905,Saro_1377,1423743,1426460,outer membrane protein assembly factor BamA,2717
SARO_RS06910,Saro_1378,1426460,1427143,membrane protein,683
SARO_RS06915,Saro_1379,1427166,1427642,beta-hydroxyacyl-ACP dehydratase,476
SARO_RS06920,Saro_1380,1427743,1427967,50S ribosomal protein L31,224
SARO_RS06925,Saro_1381,1428104,1428544,MarR family transcriptional regulator,440
SARO_RS06930,Saro_1382,1428555,1429190,oxygenase,635
SARO_RS06935,Saro_1383,1429189,1429749,type II secretion system protein GspH,560
SARO_RS06940,Saro_1384,1429739,1430173,type II secretion system protein GspI,434
SARO_RS06945,Saro_1385,1430170,1430766,type II secretion system protein GspJ,596
SARO_RS06950,Saro_1386,1430763,1431749,general secretion pathway protein GspK,986
SARO_RS06960,Saro_1387,1432097,1432825,transcriptional regulator,728
SARO_RS06965,Saro_1389,1432970,1433440,cytochrome c-type biogenesis protein CcmE,470
SARO_RS06970,Saro_1390,1433437,1435404,heme lyase CcmF/NrfE family subunit,1967
SARO_RS06975,Saro_1391,1435401,1435952,DsbE family thiol:disulfide interchange protein,551
SARO_RS06980,Saro_1392,1435949,1436389,cytochrome c-type biogenesis protein CcmH,440
SARO_RS06985,Saro_1393,1436386,1437084,tetratricopeptide repeat protein,698
SARO_RS06990,Saro_1394,1437381,1439198,potassium transporter Kup,1817
SARO_RS20180,Saro_1395,1439122,1440267,PAS domain S-box protein,1145
SARO_RS07000,Saro_1396,1440213,1440617,response regulator,404
SARO_RS20585,Saro_1397,1440684,1440989,hypothetical protein,305
SARO_RS07010,Saro_1398,1441218,1441790,membrane protein,572
SARO_RS07015,Saro_1399,1441908,1442567,septation protein A,659
SARO_RS07020,Saro_1400,1442564,1443490,signal recognition particle-docking protein FtsY,926
SARO_RS07025,Saro_1401,1443487,1444683,MiaB/RimO family radical SAM methylthiotransferase,1196
SARO_RS07030,Saro_1402,1444680,1445489,diaminopimelate epimerase,809
SARO_RS07035,Saro_1403,1445564,1447267,GGDEF-domain containing protein,1703
SARO_RS07040,Saro_1404,1447540,1449015,signal recognition particle protein,1475
SARO_RS07045,Saro_1405,1449064,1449501,30S ribosomal protein S16,437
SARO_RS07050,Saro_1406,1449501,1450004,16S rRNA processing protein RimM,503
SARO_RS07055,Saro_1407,1450001,1450741,tRNA (guanosine(37)-N1)-methyltransferase TrmD,740
SARO_RS07060,Saro_1408,1450745,1451113,50S ribosomal protein L19,368
SARO_RS07065,Saro_1409,1451278,1453542,S9 family peptidase,2264
SARO_RS07070,Saro_1410,1453782,1454807,aspartate-semialdehyde dehydrogenase,1025
SARO_RS07075,Saro_1411,1454816,1455571,alpha/beta hydrolase,755
SARO_RS07080,Saro_1412,1455670,1456146,YbjN domain-containing protein,476
SARO_RS07085,Saro_1413,1456240,1457676,AMP nucleosidase,1436
SARO_RS07090,Saro_1414,1457796,1458395,50S ribosomal protein L9,599
SARO_RS07095,Saro_1415,1458408,1458632,30S ribosomal protein S18,224
SARO_RS07100,Saro_1416,1458636,1458998,30S ribosomal protein S6,362
SARO_RS07105,Saro_1417,1459207,1459983,enoyl-CoA hydratase,776
SARO_RS07110,Saro_1418,1460006,1460431,hypothetical protein,425
SARO_RS20190,Saro_1419,1460403,1461563,acyltransferase,1160
SARO_RS07120,Saro_1420,1461592,1461879,antibiotic biosynthesis monooxygenase,287
SARO_RS07125,Saro_1421,1462057,1464231,GGDEF domain-containing protein,2174
SARO_RS07130,Saro_1422,1464323,1465267,DUF808 domain-containing protein,944
SARO_RS07135,NA,1465280,1465645,PilZ domain-containing protein,365
SARO_RS07140,Saro_1424,1465845,1466378,N-acetyltransferase,533
SARO_RS07145,Saro_1425,1466398,1467825,UDP-N-acetylmuramate--alanine ligase,1427
SARO_RS07150,Saro_1426,1467912,1468733,LD-carboxypeptidase,821
SARO_RS07155,Saro_1427,1468791,1469726,[acyl-carrier-protein] S-malonyltransferase,935
SARO_RS07160,Saro_1428,1469732,1470496,3-oxoacyl-[acyl-carrier-protein] reductase,764
SARO_RS07165,Saro_1429,1470682,1471809,DNA polymerase III subunit beta,1127
SARO_RS07170,Saro_1430,1471981,1473426,globin-coupled sensor protein,1445
SARO_RS07175,Saro_1431,1473435,1474448,NAD(P)-dependent alcohol dehydrogenase,1013
SARO_RS07180,Saro_1432,1474448,1476196,D-aminoacylase,1748
SARO_RS07185,Saro_1433,1476300,1477604,pyridine nucleotide-disulfide oxidoreductase,1304
SARO_RS07190,Saro_1434,1477676,1478461,alpha/beta hydrolase,785
SARO_RS07195,Saro_1435,1478581,1481271,PAS domain S-box protein,2690
SARO_RS07200,Saro_1436,1481281,1482534,radical SAM protein,1253
SARO_RS07205,Saro_1437,1482804,1483475,porin family protein,671
SARO_RS07210,Saro_1438,1483542,1484039,hypothetical protein,497
SARO_RS07215,Saro_1439,1484036,1484230,DUF4169 domain-containing protein,194
SARO_RS07220,Saro_1440,1484230,1484859,phosphoglycerate mutase family protein,629
SARO_RS07225,Saro_1441,1484877,1485362,transcription elongation factor GreB,485
SARO_RS07230,Saro_1442,1485464,1487482,transglycosylase,2018
SARO_RS07235,Saro_1443,1487581,1488471,4-hydroxy-tetrahydrodipicolinate synthase,890
SARO_RS07240,Saro_1444,1488542,1489024,SsrA-binding protein,482
SARO_RS07245,Saro_1445,1489133,1489693,DUF2062 domain-containing protein,560
SARO_RS07250,Saro_1446,1489693,1492128,hybrid sensor histidine kinase/response regulator,2435
SARO_RS07255,Saro_1447,1492505,1492810,DUF1905 domain-containing protein,305
SARO_RS07260,Saro_1448,1492815,1493807,peptidylprolyl isomerase,992
SARO_RS07270,Saro_1449,1494442,1496010,recombinase family protein,1568
SARO_RS07275,Saro_1450,1496007,1496474,DUF2924 domain-containing protein,467
SARO_RS20590,Saro_1451,1496474,1496884,DUF3489 domain-containing protein,410
SARO_RS07285,Saro_1452,1497036,1498343,DNA methylase N-4,1307
SARO_RS20195,Saro_1453,1498340,1498870,hypothetical protein,530
SARO_RS07295,Saro_1454,1498867,1499457,hypothetical protein,590
SARO_RS07310,Saro_1457,1500151,1501404,IS21 family transposase,1253
SARO_RS07315,Saro_1458,1501401,1502258,ATPase AAA,857
SARO_RS07330,Saro_1461,1503407,1503913,nuclear transport factor 2 family protein,506
SARO_RS07335,Saro_1462,1503934,1504452,flavin reductase,518
SARO_RS07340,Saro_1463,1504449,1505219,crotonase,770
SARO_RS07345,Saro_1464,1505223,1506062,enoyl-CoA hydratase/isomerase family protein,839
SARO_RS07350,Saro_1465,1506059,1506508,nuclear transport factor 2 family protein,449
SARO_RS07355,Saro_1467,1506861,1507511,hypothetical protein,650
SARO_RS07360,Saro_1468,1507606,1508706,LLM class flavin-dependent oxidoreductase,1100
SARO_RS07365,Saro_1469,1508743,1509897,LLM class flavin-dependent oxidoreductase,1154
SARO_RS07370,Saro_1470,1510080,1511672,fatty acid--CoA ligase,1592
SARO_RS07375,Saro_1471,1511678,1512337,TetR/AcrR family transcriptional regulator,659
SARO_RS07380,NA,1512358,1512729,hypothetical protein,371
SARO_RS07385,Saro_1472,1512835,1513257,hypothetical protein,422
SARO_RS07390,Saro_1473,1513254,1514396,3%2C4-dihydroxy-2-butanone-4-phosphate synthase,1142
SARO_RS07395,Saro_1474,1514632,1517085,TonB-dependent receptor,2453
SARO_RS07400,Saro_1475,1517212,1518012,3-oxoacyl-ACP reductase,800
SARO_RS07405,Saro_1476,1518089,1519171,5-exo-alcohol dehydrogenase,1082
SARO_RS20845,Saro_1477,1519205,1519522,ferredoxin,317
SARO_RS07415,Saro_1478,1519557,1520840,cytochrome P450,1283
SARO_RS07420,Saro_1479,1520981,1521694,MerR family transcriptional regulator,713
SARO_RS07425,Saro_1480,1521727,1523382,NAD(P)/FAD-dependent oxidoreductase,1655
SARO_RS07430,Saro_1481,1523603,1524319,IS6 family transposase,716
SARO_RS07435,Saro_1482,1524528,1525274,XRE family transcriptional regulator,746
SARO_RS20600,Saro_1483,1525404,1526213,phytanoyl-CoA dioxygenase family protein,809
SARO_RS20605,Saro_1484,1526272,1526724,nuclear transport factor 2 family protein,452
SARO_RS07450,Saro_1485,1526794,1527510,IS6 family transposase,716
SARO_RS20610,Saro_1486,1527456,1527806,hypothetical protein,350
SARO_RS07455,Saro_1487,1527910,1528980,(2Fe-2S)-binding protein,1070
SARO_RS07460,Saro_1488,1529171,1530226,aromatic ring-hydroxylating dioxygenase subunit alpha,1055
SARO_RS07465,Saro_1489,1530312,1532891,TonB-dependent receptor,2579
SARO_RS20200,Saro_1490,1532918,1534153,FAD binding domain-containing protein,1235
SARO_RS20615,Saro_1491,1534155,1534484,cytochrome c,329
SARO_RS07480,Saro_1492,1534481,1536040,FAD-binding oxidoreductase,1559
SARO_RS07485,Saro_1493,1536037,1536567,hypothetical protein,530
SARO_RS07490,Saro_1494,1536757,1538481,Fis family transcriptional regulator,1724
SARO_RS07495,Saro_1495,1538674,1539390,IS6 family transposase,716
SARO_RS07500,NA,1539369,1539857,hypothetical protein,488
SARO_RS07505,Saro_1497,1539881,1540711,hypothetical protein,830
SARO_RS07510,Saro_1498,1540830,1542164,carboxylate transporter,1334
SARO_RS07515,Saro_1499,1542170,1543513,DUF4118 domain-containing protein,1343
SARO_RS07520,Saro_1500,1543701,1545002,chloride channel protein,1301
SARO_RS07525,Saro_1501,1545008,1545943,hydrogen peroxide-inducible genes activator,935
SARO_RS07530,Saro_1502,1546343,1546900,hypothetical protein,557
SARO_RS07535,Saro_1503,1546988,1547737,trehalose-phosphatase,749
SARO_RS07540,Saro_1504,1547734,1549518,glycoside hydrolase family 15 protein,1784
SARO_RS07545,Saro_1505,1549515,1550909,trehalose-6-phosphate synthase,1394
SARO_RS07550,Saro_1506,1551018,1551734,IS6 family transposase,716
SARO_RS20620,NA,1551955,1552206,XRE family transcriptional regulator,251
SARO_RS07555,NA,1552296,1552529,hypothetical protein,233
SARO_RS07560,NA,1552530,1552868,hypothetical protein,338
SARO_RS20625,Saro_1509,1553048,1553428,ribonuclease HI,380
SARO_RS07565,Saro_1510,1553514,1554188,DNA-binding response regulator,674
SARO_RS07570,Saro_1511,1554185,1555621,DUF4118 domain-containing protein,1436
SARO_RS07575,Saro_1512,1555630,1557534,potassium transporter Kup,1904
SARO_RS07580,NA,1557945,1558718,hypothetical protein,773
SARO_RS07585,NA,1559197,1559379,hypothetical protein,182
SARO_RS07590,NA,1559452,1559640,Flp family type IVb pilin,188
SARO_RS07595,Saro_1515,1559699,1560604,Flp pilus assembly protein CpaB,905
SARO_RS07600,Saro_1516,1560594,1562147,BON domain-containing protein,1553
SARO_RS07605,Saro_1517,1562137,1562424,hypothetical protein,287
SARO_RS07610,NA,1562387,1564003,hypothetical protein,1616
SARO_RS07615,Saro_1519,1564000,1564533,pilus assembly protein,533
SARO_RS07620,Saro_1520,1564530,1565159,pilus assembly protein,629
SARO_RS07625,Saro_1521,1565184,1566404,hypothetical protein,1220
SARO_RS07630,Saro_1522,1566401,1567804,CpaF family protein,1403
SARO_RS07635,Saro_1523,1567809,1568795,secretion system protein,986
SARO_RS07640,Saro_1524,1568795,1569766,type II secretion system F family protein,971
SARO_RS07645,NA,1569807,1570424,hypothetical protein,617
SARO_RS07650,Saro_1526,1570451,1570924,peptidase A24,473
SARO_RS07655,Saro_1527,1570927,1571700,IclR family transcriptional regulator,773
SARO_RS20630,NA,1571775,1572532,IS5/IS1182 family transposase,757
SARO_RS20630,NA,1571775,1572532,IS5/IS1182 family transposase,757
SARO_RS07670,Saro_1530,1573114,1574736,NAD(P)/FAD-dependent oxidoreductase,1622
SARO_RS07675,Saro_1531,1574831,1576426,acyl-CoA synthetase,1595
SARO_RS07680,Saro_1532,1576437,1577201,enoyl-CoA hydratase,764
SARO_RS07685,Saro_1533,1577488,1579650,ligand-gated channel,2162
SARO_RS07690,Saro_1534,1579840,1580724,alpha/beta hydrolase,884
SARO_RS07695,Saro_1535,1580914,1582263,MFS transporter,1349
SARO_RS20635,Saro_1536,1582469,1583209,hypothetical protein,740
SARO_RS07700,Saro_1537,1583121,1584665,DNA polymerase Y family protein,1544
SARO_RS07705,Saro_1538,1584662,1587898,error-prone DNA polymerase,3236
SARO_RS07710,Saro_1539,1587982,1589310,FAD-binding oxidoreductase,1328
SARO_RS07715,Saro_1540,1589321,1590565,MFS transporter,1244
SARO_RS07720,Saro_1541,1590650,1591225,TetR/AcrR family transcriptional regulator,575
SARO_RS07725,Saro_1542,1591258,1593513,hypothetical protein,2255
SARO_RS07730,Saro_1543,1593855,1595447,choline dehydrogenase,1592
SARO_RS07740,Saro_1545,1598538,1599911,MFS transporter,1373
SARO_RS07745,Saro_1546,1599944,1600894,TauD/TfdA family dioxygenase,950
SARO_RS07750,Saro_1547,1601033,1601923,MurR/RpiR family transcriptional regulator,890
SARO_RS07755,Saro_1548,1602156,1604336,TonB-dependent receptor,2180
SARO_RS07760,Saro_1549,1604434,1605384,phosphate/phosphite/phosphonate ABC transporter substrate-binding protein,950
SARO_RS07765,Saro_1550,1605381,1606103,ABC transporter-like protein,722
SARO_RS07770,Saro_1551,1606100,1607053,phosphonate ABC transporter%2C permease protein PhnE,953
SARO_RS07775,Saro_1552,1607077,1609185,phospholipase C%2C phosphocholine-specific,2108
SARO_RS07780,Saro_1553,1609227,1610573,histidine kinase,1346
SARO_RS07785,Saro_1554,1610570,1611058,pyridoxamine 5'-phosphate oxidase family protein,488
SARO_RS07790,Saro_1555,1611187,1612068,arylamine N-acetyltransferase,881
SARO_RS07795,Saro_1556,1612093,1612620,hypothetical protein,527
SARO_RS07800,Saro_1557,1612743,1613537,IclR family transcriptional regulator,794
SARO_RS07805,Saro_1558,1613598,1615247,NAD(P)/FAD-dependent oxidoreductase,1649
SARO_RS07810,Saro_1559,1615327,1617519,ligand-gated channel,2192
SARO_RS07815,Saro_1560,1617712,1618485,NAD(P)-dependent oxidoreductase,773
SARO_RS07820,Saro_1561,1618665,1620215,KR domain-containing protein,1550
SARO_RS07825,Saro_1562,1620330,1621094,enoyl-CoA hydratase,764
SARO_RS07830,Saro_1563,1621111,1622706,acyl-CoA synthetase,1595
SARO_RS07835,Saro_1564,1622710,1623423,NAD(P)-dependent oxidoreductase,713
SARO_RS07840,Saro_1565,1623417,1623935,short-chain dehydrogenase/reductase,518
SARO_RS07845,Saro_1566,1623987,1624754,IclR family transcriptional regulator,767
SARO_RS07850,Saro_1567,1624862,1625746,SMP-30/gluconolactonase/LRE family protein,884
SARO_RS07855,Saro_1568,1625751,1626938,acyl-CoA dehydrogenase,1187
SARO_RS07860,Saro_1569,1626947,1628056,acyl-CoA dehydrogenase,1109
SARO_RS07865,Saro_1570,1628053,1628577,nuclear transport factor 2 family protein,524
SARO_RS07870,Saro_1571,1628596,1629372,thioesterase family protein,776
SARO_RS07875,Saro_1572,1629369,1630460,12-oxophytodienoate reductase,1091
SARO_RS07880,Saro_1573,1630555,1630848,DUF1971 domain-containing protein,293
SARO_RS07885,Saro_1574,1630845,1631228,preprotein translocase subunit TatC,383
SARO_RS07890,Saro_1575,1631230,1631577,hypothetical protein,347
SARO_RS07895,Saro_1576,1631614,1632303,oxidase,689
SARO_RS07900,Saro_1577,1632386,1633933,PAS domain-containing sensor histidine kinase,1547
SARO_RS07905,Saro_1578,1633923,1634546,DNA-binding response regulator,623
SARO_RS07910,Saro_1579,1634560,1635861,4-hydroxybutyrate CoA-transferase,1301
SARO_RS07915,Saro_1580,1636020,1637672,FAD-binding protein,1652
SARO_RS07920,Saro_1581,1638057,1638317,hypothetical protein,260
SARO_RS07925,Saro_1582,1638340,1639614,3%2C4-dihydroxy-2-butanone-4-phosphate synthase,1274
SARO_RS07930,NA,1639811,1640020,hypothetical protein,209
SARO_RS07935,Saro_1583,1640051,1641124,hypothetical protein,1073
SARO_RS07940,Saro_1584,1641127,1642695,carboxylesterase,1568
SARO_RS07945,Saro_1585,1642692,1643663,alpha/beta hydrolase,971
SARO_RS07950,Saro_1586,1643707,1645572,sugar phosphate isomerase/epimerase and 4-hydroxyphenylpyruvate domain-containing protein,1865
SARO_RS07955,Saro_1587,1645775,1646542,TetR/AcrR family transcriptional regulator,767
SARO_RS07960,Saro_1588,1646637,1647869,MFS transporter,1232
SARO_RS07965,Saro_1589,1647915,1650911,TonB-dependent receptor,2996
SARO_RS07970,Saro_1590,1650970,1651800,shikimate dehydrogenase,830
SARO_RS07975,Saro_1591,1651802,1652491,hypothetical protein,689
SARO_RS07980,Saro_1592,1652488,1653054,RNA polymerase sigma factor,566
SARO_RS07985,Saro_1593,1653118,1654308,peptidase S8,1190
SARO_RS07995,Saro_1595,1655345,1658650,polysaccharide deacetylase,3305
SARO_RS08000,Saro_1596,1658647,1659384,type IV secretion pathway VirJ component-like protein,737
SARO_RS08005,Saro_1597,1659381,1662014,bifunctional lysylphosphatidylglycerol flippase/synthetase MprF,2633
SARO_RS08010,Saro_1598,1662011,1662445,DUF2147 domain-containing protein,434
SARO_RS08015,Saro_1599,1662598,1663284,DNA-binding response regulator,686
SARO_RS08020,Saro_1600,1663284,1664690,sensor histidine kinase,1406
SARO_RS08025,Saro_1601,1664720,1666051,chromate transporter,1331
SARO_RS08030,Saro_1602,1666217,1667824,MBL fold metallo-hydrolase,1607
SARO_RS08035,Saro_1603,1667939,1670911,TonB-dependent receptor,2972
SARO_RS08040,Saro_1604,1671027,1672568,tryptophan 7-halogenase,1541
SARO_RS08045,Saro_1605,1672565,1673287,multidrug transporter,722
SARO_RS08050,Saro_1606,1673271,1674287,cupin-like domain-containing protein,1016
SARO_RS08055,Saro_1607,1674284,1675801,tryptophan 7-halogenase,1517
SARO_RS08060,Saro_1608,1675798,1676718,glycoside hydrolase family 16 protein,920
SARO_RS08065,Saro_1609,1676725,1677795,LacI family DNA-binding transcriptional regulator,1070
SARO_RS08070,Saro_1610,1677803,1679017,MFS transporter,1214
SARO_RS08075,Saro_1611,1679091,1681526,1%2C4-beta-D-glucan glucohydrolase,2435
SARO_RS08080,Saro_1612,1681543,1681866,hypothetical protein,323
SARO_RS08085,Saro_1613,1682054,1682995,NAD(P)/FAD-dependent oxidoreductase,941
SARO_RS08090,Saro_1614,1683390,1684055,DNA-binding response regulator,665
SARO_RS08095,Saro_1615,1684254,1686080,PAS domain-containing sensor histidine kinase,1826
SARO_RS08100,Saro_1616,1686073,1686729,DNA-binding response regulator,656
SARO_RS08105,NA,1686892,1687071,hypothetical protein,179
SARO_RS08110,Saro_1618,1687215,1688267,UDP-glucose 4-epimerase GalE,1052
SARO_RS08115,Saro_1619,1688627,1692235,cadherin,3608
SARO_RS08120,Saro_1620,1692252,1693646,hypothetical protein,1394
SARO_RS08125,Saro_1621,1693643,1694503,hypothetical protein,860
SARO_RS08130,Saro_1622,1694500,1696245,hypothetical protein,1745
SARO_RS08135,Saro_1623,1696251,1697762,tetratricopeptide repeat-containing protein,1511
SARO_RS20205,Saro_1624,1697759,1698775,hypothetical protein,1016
SARO_RS08145,Saro_1625,1698772,1699644,hypothetical protein,872
SARO_RS08150,Saro_1626,1699641,1701191,DUF3492 domain-containing protein,1550
SARO_RS08155,Saro_1627,1701688,1702422,DNA-binding response regulator,734
SARO_RS08165,Saro_1628,1702722,1703126,hypothetical protein,404
SARO_RS08170,Saro_1629,1703348,1705504,TonB-dependent receptor,2156
SARO_RS08175,Saro_1630,1705501,1706886,PepSY domain-containing protein,1385
SARO_RS08180,Saro_1631,1706922,1707605,DNA-binding response regulator,683
SARO_RS08185,Saro_1632,1707602,1709116,sensor histidine kinase,1514
SARO_RS20640,Saro_1633,1709469,1709672,hypothetical protein,203
SARO_RS08195,Saro_1634,1709675,1710853,NAD(P)/FAD-dependent oxidoreductase,1178
SARO_RS08200,Saro_1635,1710850,1712469,NAD(P)/FAD-dependent oxidoreductase,1619
SARO_RS08205,Saro_1636,1712512,1713090,nitroreductase,578
SARO_RS08210,Saro_1637,1713166,1713579,DoxX family protein,413
SARO_RS08215,Saro_1638,1713633,1714364,pirin family protein,731
SARO_RS08220,Saro_1639,1714489,1715418,LysR family transcriptional regulator,929
SARO_RS08225,Saro_1640,1715452,1715703,hypothetical protein,251
SARO_RS08230,Saro_1641,1715870,1716319,MaoC family dehydratase,449
SARO_RS08235,Saro_1642,1716319,1718190,acetyl/propionyl/methylcrotonyl-CoA carboxylase subunit alpha,1871
SARO_RS08240,Saro_1643,1718205,1719818,acetyl-CoA carboxylase subunit beta,1613
SARO_RS08245,Saro_1644,1719815,1720801,esterase,986
SARO_RS08250,Saro_1645,1720822,1721985,isovaleryl-CoA dehydrogenase,1163
SARO_RS08255,Saro_1646,1722084,1722953,LysR family transcriptional regulator,869
SARO_RS08260,Saro_1647,1722938,1723573,twin-arginine translocation pathway signal protein,635
SARO_RS08265,Saro_1648,1723704,1724894,cytochrome P450,1190
SARO_RS08270,Saro_1649,1725007,1725918,AraC family transcriptional regulator,911
SARO_RS08275,Saro_1650,1725915,1726571,TetR/AcrR family transcriptional regulator,656
SARO_RS08280,Saro_1651,1726699,1727028,cytochrome c,329
SARO_RS08285,Saro_1652,1727025,1728656,FAD-binding oxidoreductase,1631
SARO_RS08290,Saro_1653,1728773,1729426,alpha/beta hydrolase,653
SARO_RS08295,Saro_1654,1729430,1731196,glycogen debranching enzyme GlgX,1766
SARO_RS08300,Saro_1655,1731193,1732821,alpha-D-glucose phosphate-specific phosphoglucomutase,1628
SARO_RS08305,Saro_1656,1732818,1734275,glycogen synthase,1457
SARO_RS08310,Saro_1657,1734272,1735531,glucose-1-phosphate adenylyltransferase,1259
SARO_RS08315,Saro_1658,1735553,1737718,glycogen-branching enzyme,2165
SARO_RS08320,Saro_1659,1737715,1740138,glycogen/starch/alpha-glucan phosphorylase,2423
SARO_RS08325,Saro_1661,1740519,1741058,cytochrome b,539
SARO_RS08330,Saro_1662,1741060,1743120,TonB-dependent receptor,2060
SARO_RS08335,Saro_1663,1743356,1743559,hypothetical protein,203
SARO_RS08340,Saro_1664,1743718,1745310,hybrid sensor histidine kinase/response regulator,1592
SARO_RS08345,Saro_1665,1745307,1746230,DNA-binding response regulator,923
SARO_RS08350,Saro_1666,1746280,1746594,UrcA family protein,314
SARO_RS08355,Saro_1667,1747042,1748031,NADPH:quinone oxidoreductase family protein,989
SARO_RS08360,Saro_1668,1748389,1749789,salicylaldehyde dehydrogenase,1400
SARO_RS08365,Saro_1669,1749818,1750672,crotonase,854
SARO_RS08370,Saro_1670,1750798,1752201,hypothetical protein,1403
SARO_RS08375,Saro_1671,1752191,1752796,TetR family transcriptional regulator,605
SARO_RS08380,Saro_1672,1752855,1754036,aromatic ring-hydroxylating dioxygenase subunit alpha,1181
SARO_RS08385,Saro_1673,1754081,1755694,NAD(P)/FAD-dependent oxidoreductase,1613
SARO_RS08390,Saro_1674,1755648,1756964,amino acid permease,1316
SARO_RS08395,Saro_1675,1757069,1758697,sulfotransferase family protein,1628
SARO_RS08400,Saro_1676,1758826,1761453,TonB-denpendent receptor,2627
SARO_RS08405,Saro_1677,1761461,1762420,ketopantoate reductase family protein,959
SARO_RS08410,Saro_1678,1762454,1763410,LysR family transcriptional regulator,956
SARO_RS08415,Saro_1679,1763443,1764999,benzoylformate decarboxylase,1556
SARO_RS08420,Saro_1680,1764996,1766339,ribosomal subunit interface protein,1343
SARO_RS08425,Saro_1681,1766336,1766836,aromatic-ring-hydroxylating dioxygenase subunit beta,500
SARO_RS08430,Saro_1682,1766893,1768008,alanine dehydrogenase,1115
SARO_RS08435,Saro_1683,1768151,1768621,Lrp/AsnC family transcriptional regulator,470
SARO_RS08440,Saro_1684,1768599,1769282,TetR/AcrR family transcriptional regulator,683
SARO_RS08445,Saro_1685,1769431,1770606,amine dehydrogenase,1175
SARO_RS08450,Saro_1686,1770509,1771093,hypothetical protein,584
SARO_RS08455,Saro_1687,1771078,1771683,methylamine dehydrogenase,605
SARO_RS08460,Saro_1688,1771687,1772247,methylamine dehydrogenase light chain,560
SARO_RS08465,Saro_1689,1772244,1772702,cytochrome c,458
SARO_RS08470,Saro_1690,1772747,1773172,hypothetical protein,425
SARO_RS08475,Saro_1691,1773187,1775418,TonB-dependent receptor,2231
SARO_RS08480,Saro_1692,1775460,1776863,aldehyde dehydrogenase,1403
SARO_RS08485,Saro_1693,1776860,1778491,fatty acid--CoA ligase,1631
SARO_RS08490,Saro_1694,1778608,1779465,Ku protein,857
SARO_RS08495,Saro_1695,1779469,1782000,DNA ligase D,2531
SARO_RS08500,Saro_1696,1782016,1783392,class II fumarate hydratase,1376
SARO_RS08505,Saro_1697,1783416,1783826,low affinity iron permease family protein,410
SARO_RS08510,Saro_1698,1783835,1784023,DUF3008 domain-containing protein,188
SARO_RS08515,Saro_1699,1784178,1785101,sulfotransferase,923
SARO_RS08520,Saro_1700,1785131,1785691,nucleotidyltransferase family protein,560
SARO_RS08525,Saro_1701,1785688,1786665,hypothetical protein,977
SARO_RS08530,Saro_1702,1786675,1788837,xanthine dehydrogenase family protein molybdopterin-binding subunit,2162
SARO_RS08535,Saro_1703,1788834,1789337,(2Fe-2S)-binding protein,503
SARO_RS08540,NA,1789432,1790208,TetR family transcriptional regulator,776
SARO_RS08545,Saro_1705,1790371,1791552,acyl-CoA dehydrogenase,1181
SARO_RS08550,Saro_1706,1791549,1792616,phosphotransferase family protein,1067
SARO_RS20645,Saro_1707,1793486,1793659,DUF2292 domain-containing protein,173
SARO_RS08555,Saro_1708,1793755,1796181,TonB-dependent receptor,2426
SARO_RS08560,Saro_1709,1796243,1797076,TIGR00266 family protein,833
SARO_RS20210,Saro_1710,1797083,1797823,TetR/AcrR family transcriptional regulator,740
SARO_RS08570,Saro_1711,1797851,1799113,cytochrome b561,1262
SARO_RS08575,Saro_1712,1799103,1799798,TetR/AcrR family transcriptional regulator,695
SARO_RS08580,Saro_1713,1800022,1801488,RND transporter,1466
SARO_RS08585,Saro_1714,1801488,1803086,MFS transporter,1598
SARO_RS08590,Saro_1715,1803083,1804234,HlyD family secretion protein,1151
SARO_RS08595,Saro_1717,1804839,1805402,peroxiredoxin,563
SARO_RS08600,Saro_1718,1805578,1807137,alkyl hydroperoxide reductase subunit F,1559
SARO_RS08605,Saro_1719,1807270,1809192,glycoside hydrolase family 3 protein,1922
SARO_RS08610,Saro_1720,1809265,1810731,ATP-binding protein,1466
SARO_RS08615,Saro_1721,1810735,1811271,DUF3237 domain-containing protein,536
SARO_RS08620,Saro_1722,1811380,1811967,MarR family transcriptional regulator,587
SARO_RS08625,Saro_1723,1812029,1812403,cytochrome c family protein,374
SARO_RS08630,Saro_1724,1812584,1814701,bifunctional rhamnulose-1-phosphate aldolase/short-chain dehydrogenase,2117
SARO_RS08635,Saro_1725,1814724,1815650,dienelactone hydrolase,926
SARO_RS08640,Saro_1726,1815647,1816936,L-rhamnose catabolism isomerase,1289
SARO_RS08645,Saro_1727,1816983,1820396,glycoside hydrolase,3413
SARO_RS08650,Saro_1728,1820365,1821411,LacI family DNA-binding transcriptional regulator,1046
SARO_RS08655,Saro_1729,1821701,1823914,glycosyl hydrolase,2213
SARO_RS08660,Saro_1730,1823917,1825410,carboxylesterase type B,1493
SARO_RS08665,Saro_1731,1825510,1825944,Rrf2 family transcriptional regulator,434
SARO_RS08670,Saro_1732,1826055,1826861,outer membrane protein assembly factor BamD,806
SARO_RS08675,Saro_1733,1826910,1827863,DUF481 domain-containing protein,953
SARO_RS08680,Saro_1734,1827972,1829036,glycosyltransferase family 1 protein,1064
SARO_RS08685,Saro_1735,1829033,1829944,UDP-2%2C3-diacylglucosamine diphosphatase,911
SARO_RS08690,Saro_1736,1830078,1831742,DNA repair protein RecN,1664
SARO_RS08695,Saro_1737,1831758,1832441,GNAT family N-acetyltransferase,683
SARO_RS08700,Saro_1738,1832438,1834603,DNA ligase (NAD(+)) LigA,2165
SARO_RS08705,Saro_1739,1834609,1835235,LysE family translocator,626
SARO_RS08710,Saro_1740,1835243,1835746,CinA family protein,503
SARO_RS08715,Saro_1741,1835731,1836528,enoyl-CoA hydratase,797
SARO_RS08720,Saro_1742,1836751,1837707,50S ribosomal protein L11 methyltransferase,956
SARO_RS08725,Saro_1743,1837704,1838573,subclass B3 metallo-beta-lactamase,869
SARO_RS08730,Saro_1744,1838728,1839153,succinate dehydrogenase%2C cytochrome b556 subunit,425
SARO_RS08735,Saro_1745,1839192,1839575,succinate dehydrogenase%2C hydrophobic membrane anchor protein,383
SARO_RS08740,Saro_1746,1839579,1841393,succinate dehydrogenase flavoprotein subunit,1814
SARO_RS20215,Saro_1747,1841531,1842238,hypothetical protein,707
SARO_RS08755,Saro_1749,1843203,1844057,zinc metalloprotease,854
SARO_RS08760,Saro_1750,1844153,1844938,3-hydroxybutyrate dehydrogenase,785
SARO_RS08765,Saro_1751,1845101,1846600,peptidase M28,1499
SARO_RS08770,Saro_1752,1846669,1848126,IMP dehydrogenase,1457
SARO_RS08775,Saro_1753,1848137,1849324,RNA methyltransferase,1187
SARO_RS08780,Saro_1754,1849331,1849885,tetratricopeptide repeat protein,554
SARO_RS08785,Saro_1755,1849895,1850380,RNA pyrophosphohydrolase,485
SARO_RS08790,Saro_1756,1850377,1851333,alpha/beta hydrolase,956
SARO_RS08795,Saro_1757,1851520,1853424,2-oxoacid:acceptor oxidoreductase subunit alpha,1904
SARO_RS08800,Saro_1758,1853436,1854476,2-oxoacid ferredoxin oxidoreductase subunit beta,1040
SARO_RS08805,Saro_1759,1854600,1855964,deoxyribodipyrimidine photo-lyase,1364
SARO_RS08810,Saro_1760,1856001,1857272,class I SAM-dependent methyltransferase,1271
SARO_RS08815,Saro_1761,1857280,1857633,PilZ domain-containing protein,353
SARO_RS08820,Saro_1762,1857722,1858453,KR domain-containing protein,731
SARO_RS08825,Saro_1763,1858454,1859944,amidophosphoribosyltransferase,1490
SARO_RS08830,Saro_1764,1860227,1861168,integral membrane sensor protein,941
SARO_RS08835,Saro_1765,1861258,1862499,lipoprotein-releasing system transmembrane subunit%2C LolC/LolE family,1241
SARO_RS08840,Saro_1766,1862492,1863166,lipoprotein-releasing system ATP-binding protein LolD,674
SARO_RS08845,Saro_1767,1863220,1863486,hypothetical protein,266
SARO_RS08850,Saro_1768,1863552,1863785,hypothetical protein,233
SARO_RS08855,Saro_1769,1863782,1864270,glutathione peroxidase,488
SARO_RS08860,Saro_1770,1864346,1867936,DNA polymerase III subunit alpha,3590
SARO_RS08865,Saro_1771,1867979,1869577,long-chain-fatty-acid--CoA ligase,1598
SARO_RS08870,Saro_1772,1869570,1870046,DUF1330 domain-containing protein,476
SARO_RS08875,Saro_1773,1870043,1871179,radical SAM protein,1136
SARO_RS20220,Saro_1774,1871233,1872684,two-component sensor histidine kinase,1451
SARO_RS08885,Saro_1775,1872681,1873412,DNA-binding response regulator,731
SARO_RS08890,NA,1873372,1873950,hypothetical protein,578
SARO_RS20655,Saro_1777,1874166,1875167,YHYH protein,1001
SARO_RS08900,Saro_1778,1875277,1875804,molybdenum cofactor biosynthesis protein B,527
SARO_RS08905,Saro_1779,1875794,1877572,lytic murein transglycosylase,1778
SARO_RS08910,Saro_1780,1877572,1878348,hypothetical protein,776
SARO_RS08915,Saro_1781,1878453,1880102,electron transfer flavoprotein-ubiquinone oxidoreductase,1649
SARO_RS08920,Saro_1782,1880173,1880976,4-(cytidine 5'-diphospho)-2-C-methyl-D-erythritol kinase,803
SARO_RS08925,Saro_1783,1880973,1881695,N-formylglutamate amidohydrolase,722
SARO_RS08930,Saro_1784,1881817,1883664,dihydroxy-acid dehydratase,1847
SARO_RS08935,Saro_1785,1883666,1884019,hypothetical protein,353
SARO_RS08940,Saro_1786,1884003,1885409,bifunctional ADP-dependent NAD(P)H-hydrate dehydratase/NAD(P)H-hydrate epimerase,1406
SARO_RS08945,Saro_1787,1885409,1886614,class I SAM-dependent RNA methyltransferase,1205
SARO_RS08950,Saro_1788,1886619,1887047,MAPEG family protein,428
SARO_RS08955,Saro_1789,1887082,1887516,MAPEG family protein,434
SARO_RS08960,Saro_1790,1887709,1888914,saccharopine dehydrogenase,1205
SARO_RS08965,Saro_1791,1888914,1889264,histidine kinase,350
SARO_RS08970,Saro_1792,1889275,1890474,carboxynorspermidine decarboxylase,1199
SARO_RS08975,Saro_1793,1890515,1891741,6-aminohexanoate-dimer hydrolase,1226
SARO_RS08980,Saro_1794,1891915,1893120,type III PLP-dependent enzyme,1205
SARO_RS08985,Saro_1795,1893193,1893585,DUF1232 domain-containing protein,392
SARO_RS08990,Saro_1796,1893626,1894309,nitroreductase,683
SARO_RS08995,Saro_1797,1894532,1895752,5-aminolevulinate synthase,1220
SARO_RS09000,Saro_1798,1895894,1896814,MBL fold hydrolase,920
SARO_RS09005,Saro_1799,1896831,1897664,glutamate racemase,833
SARO_RS09010,Saro_1800,1897735,1898328,glycerol-3-phosphate acyltransferase,593
SARO_RS09015,Saro_1801,1898325,1899452,DNA-protecting protein DprA,1127
SARO_RS09020,Saro_1802,1899458,1899820,hypothetical protein,362
SARO_RS09025,Saro_1803,1899884,1902463,type I DNA topoisomerase,2579
SARO_RS09030,Saro_1804,1902515,1904047,hypothetical protein,1532
SARO_RS09035,Saro_1805,1904223,1905077,SGNH/GDSL hydrolase family protein,854
SARO_RS09040,Saro_1806,1905065,1905958,GTPase Era,893
SARO_RS09045,Saro_1807,1906007,1906705,ribonuclease III,698
SARO_RS09050,Saro_1808,1906678,1907541,signal peptidase I,863
SARO_RS09055,Saro_1809,1907699,1909222,glucose-6-phosphate isomerase,1523
SARO_RS09060,Saro_1810,1909311,1910672,glutathione-disulfide reductase,1361
SARO_RS09065,Saro_1811,1910740,1911462,KR domain-containing protein,722
SARO_RS09070,Saro_1812,1911497,1912246,molybdopterin-binding protein,749
SARO_RS09075,Saro_1813,1912243,1913142,DUF4405 domain-containing protein,899
SARO_RS09080,Saro_1814,1913169,1914140,phytoene/squalene synthase family protein,971
SARO_RS09085,Saro_1815,1914145,1914726,TIGR00730 family Rossman fold protein,581
SARO_RS09090,Saro_1816,1914723,1916201,phytoene desaturase,1478
SARO_RS09095,Saro_1817,1916198,1917394,lycopene cyclase,1196
SARO_RS09100,Saro_1818,1917535,1918086,hypothetical protein,551
SARO_RS09105,Saro_1819,1918216,1919733,NAD(P)/FAD-dependent oxidoreductase,1517
SARO_RS09110,Saro_1820,1919909,1921273,monooxygenase,1364
SARO_RS09115,Saro_1821,1921284,1922516,cytochrome P450,1232
SARO_RS09120,Saro_1822,1922605,1923888,hypothetical protein,1283
SARO_RS09125,Saro_1823,1923888,1925978,TonB-dependent siderophore receptor,2090
SARO_RS09130,Saro_1824,1926312,1928192,phosphomethylpyrimidine synthase,1880
SARO_RS09135,Saro_1825,1928289,1928696,GFA family protein,407
SARO_RS09140,Saro_1826,1928742,1929137,DUF4440 domain-containing protein,395
SARO_RS09145,Saro_1827,1929205,1929600,hypothetical protein,395
SARO_RS09150,Saro_1828,1929593,1930033,hypothetical protein,440
SARO_RS09155,Saro_1829,1930221,1930520,hypothetical protein,299
SARO_RS09160,Saro_1830,1930793,1931098,PhnA protein,305
SARO_RS09165,Saro_1831,1931151,1931903,sulfite exporter TauE/SafE family protein,752
SARO_RS09170,Saro_1832,1931908,1932312,membrane protein,404
SARO_RS09175,Saro_1833,1932309,1932746,cupin,437
SARO_RS09180,Saro_1834,1932781,1933176,hypothetical protein,395
SARO_RS09185,Saro_1835,1933469,1934308,2%2C3%2C4%2C5-tetrahydropyridine-2%2C6-dicarboxylate N-succinyltransferase,839
SARO_RS09190,Saro_1836,1934355,1935044,pyrimidine 5'-nucleotidase,689
SARO_RS09195,Saro_1837,1935151,1937463,peptidase S8,2312
SARO_RS09200,Saro_1838,1937510,1938643,PQQ-dependent sugar dehydrogenase,1133
SARO_RS09205,Saro_1839,1938693,1939283,ribonuclease HII,590
SARO_RS09210,Saro_1840,1939534,1940676,site-specific DNA-methyltransferase,1142
SARO_RS09215,Saro_1841,1940747,1941853,dihydropteroate synthase,1106
SARO_RS09220,Saro_1842,1941856,1943274,sigma-54-dependent Fis family transcriptional regulator,1418
SARO_RS20660,NA,1943427,1943564,aa3-type cytochrome c oxidase subunit IV,137
SARO_RS09225,Saro_1843,1943584,1944699,NAD(P) transhydrogenase subunit alpha,1115
SARO_RS09230,Saro_1844,1944711,1944995,NAD(P) transhydrogenase subunit alpha,284
SARO_RS09235,Saro_1845,1944995,1946407,NAD synthetase,1412
SARO_RS09240,Saro_1846,1946434,1946736,hypothetical protein,302
SARO_RS09245,Saro_1847,1946888,1947580,aspartate racemase,692
SARO_RS09250,Saro_1848,1947719,1948885,deoxyguanosinetriphosphate triphosphohydrolase,1166
SARO_RS09255,Saro_1849,1948878,1949567,nucleoside-diphosphate sugar epimerase,689
SARO_RS09260,Saro_1850,1949880,1951046,glycine cleavage system aminomethyltransferase T,1166
SARO_RS09265,Saro_1851,1951046,1951417,glycine cleavage system protein H,371
SARO_RS09270,Saro_1852,1951422,1952780,glycine dehydrogenase (decarboxylating),1358
SARO_RS09275,Saro_1853,1952777,1954336,glycine dehydrogenase (aminomethyl-transferring),1559
SARO_RS09280,NA,1954414,1954545,entericidin%2C EcnA/B family,131
SARO_RS09285,Saro_1854,1954635,1955552,EamA/RhaT family transporter,917
SARO_RS09290,NA,1955595,1955813,hypothetical protein,218
SARO_RS09295,Saro_1856,1955826,1957391,CpaF family protein,1565
SARO_RS09300,Saro_1857,1957674,1958576,EamA/RhaT family transporter,902
SARO_RS09305,Saro_1858,1958674,1959516,haloacid dehalogenase,842
SARO_RS09310,Saro_1859,1959513,1960985,biotin carboxyl carrier protein,1472
SARO_RS09315,Saro_1860,1960982,1962316,ATP-grasp domain-containing protein,1334
SARO_RS09320,Saro_1861,1962318,1962761,acetyl-CoA carboxylase biotin carboxyl carrier protein subunit,443
SARO_RS09325,Saro_1862,1962769,1963989,UPF0261 family protein,1220
SARO_RS09330,Saro_1863,1964115,1964915,IclR family transcriptional regulator,800
SARO_RS09335,Saro_1864,1964998,1966011,NAD(P)-dependent alcohol dehydrogenase,1013
SARO_RS09340,Saro_1865,1966070,1966615,VOC family protein,545
SARO_RS09345,Saro_1866,1966737,1968014,MFS transporter,1277
SARO_RS09350,Saro_1867,1968031,1968969,AraC family transcriptional regulator,938
SARO_RS09355,Saro_1868,1969087,1971690,TonB-dependent receptor,2603
SARO_RS09360,Saro_1869,1971767,1972300,cupin domain-containing protein,533
SARO_RS09365,Saro_1870,1972326,1972862,hypothetical protein,536
SARO_RS09370,Saro_1871,1972870,1973403,hypothetical protein,533
SARO_RS09375,Saro_1872,1973414,1974484,aromatic ring-hydroxylating dioxygenase subunit alpha,1070
SARO_RS09380,Saro_1873,1974514,1975353,KR domain-containing protein,839
SARO_RS09385,Saro_1874,1975363,1976370,Zn-dependent alcohol dehydrogenase,1007
SARO_RS09390,Saro_1875,1976401,1977243,KR domain-containing protein,842
SARO_RS09395,Saro_1876,1977248,1978189,intradiol ring-cleavage dioxygenase,941
SARO_RS09400,Saro_1877,1978475,1979797,MFS transporter,1322
SARO_RS09405,Saro_1878,1979797,1981896,glycoside hydrolase,2099
SARO_RS09410,Saro_1879,1981934,1983067,glycoside hydrolase family 68 protein,1133
SARO_RS09415,Saro_1880,1983088,1984122,LacI family transcriptional regulator,1034
SARO_RS09420,Saro_1881,1984386,1986902,TonB-dependent receptor,2516
SARO_RS09425,Saro_1882,1987056,1988561,tryptophan 7-halogenase,1505
SARO_RS09430,Saro_1883,1988468,1989931,hypothetical protein,1463
SARO_RS09435,NA,1989933,1991255,glycoside hydrolase,1322
SARO_RS09440,Saro_1885,1991234,1992139,fructokinase,905
SARO_RS09445,Saro_1886,1992136,1993620,MFS transporter,1484
SARO_RS09450,Saro_1887,1993798,1994832,LacI family transcriptional regulator,1034
SARO_RS09455,Saro_1888,1995165,1997885,TonB-dependent receptor,2720
SARO_RS09460,Saro_1889,1998001,1999515,tryptophan 7-halogenase,1514
SARO_RS09465,Saro_1890,1999508,2001337,alpha-amylase,1829
SARO_RS09470,Saro_1891,2001334,2002968,DUF3459 domain-containing protein,1634
SARO_RS09475,Saro_1892,2002968,2005016,alpha-glucosidase,2048
SARO_RS09480,Saro_1893,2005196,2006644,glucose-6-phosphate dehydrogenase,1448
SARO_RS09485,Saro_1894,2006637,2007263,6-phosphogluconolactonase,626
SARO_RS09490,Saro_1895,2007263,2009083,phosphogluconate dehydratase,1820
SARO_RS09495,Saro_1896,2009128,2010096,glucokinase,968
SARO_RS09500,Saro_1897,2010219,2011001,enoyl-CoA hydratase,782
SARO_RS09505,Saro_1898,2011040,2011489,DUF488 domain-containing protein,449
SARO_RS09510,Saro_1899,2011490,2012599,3-dehydroquinate synthase,1109
SARO_RS09515,Saro_1900,2012590,2013171,shikimate kinase,581
SARO_RS09520,Saro_1901,2013392,2015284,hypothetical protein,1892
SARO_RS09525,Saro_1902,2015288,2016169,tyrosine recombinase,881
SARO_RS09530,Saro_1903,2016202,2017146,acetyl-CoA carboxylase carboxyltransferase subunit alpha,944
SARO_RS09535,Saro_1904,2017265,2018746,LysM peptidoglycan-binding domain-containing protein,1481
SARO_RS09540,Saro_1905,2018861,2019040,Flp family type IVb pilin,179
SARO_RS09545,Saro_1906,2019139,2019327,Flp family type IVb pilin,188
SARO_RS09550,Saro_1907,2019395,2019844,(deoxy)nucleoside triphosphate pyrophosphohydrolase,449
SARO_RS09565,Saro_1908,2020408,2021457,pyruvate dehydrogenase (acetyl-transferring) E1 component subunit alpha,1049
SARO_RS09570,Saro_1909,2021459,2022844,pyruvate dehydrogenase complex E1 component subunit beta,1385
SARO_RS09575,Saro_1910,2023108,2023530,pilus assembly protein,422
SARO_RS09580,Saro_1911,2023527,2023931,pilus assembly protein,404
SARO_RS09585,Saro_1912,2023985,2025331,hypothetical protein,1346
SARO_RS09590,Saro_1913,2025586,2026017,hypothetical protein,431
SARO_RS09595,Saro_1914,2026101,2026571,hypothetical protein,470
SARO_RS09600,Saro_1915,2026593,2027963,FADH(2)-oxidizing methylenetetrahydrofolate--tRNA-(uracil(54)-C(5))-methyltransferase TrmFO,1370
SARO_RS09605,Saro_1916,2028031,2028711,lysoplasmalogenase,680
SARO_RS09610,Saro_1917,2028689,2029042,DUF952 domain-containing protein,353
SARO_RS09615,Saro_1918,2029039,2031765,DNA gyrase subunit A,2726
SARO_RS09620,Saro_1919,2032081,2033382,hypothetical protein,1301
SARO_RS09625,Saro_1920,2033469,2034122,carbonic anhydrase,653
SARO_RS09630,Saro_1921,2034189,2035121,lipoyl synthase,932
SARO_RS09635,Saro_1922,2035124,2035585,ubiquinone-binding protein,461
SARO_RS09640,Saro_1923,2035546,2036049,CinA family protein,503
SARO_RS09645,NA,2036054,2036623,hypothetical protein,569
SARO_RS09650,Saro_1925,2036643,2037803,bifunctional 2-C-methyl-D-erythritol 4-phosphate cytidylyltransferase/2-C-methyl-D-erythritol 2%2C4-cyclodiphosphate synthase,1160
SARO_RS09655,Saro_1926,2037905,2038960,tRNA dihydrouridine synthase DusB,1055
SARO_RS09660,Saro_1927,2038957,2040078,PAS domain-containing sensor histidine kinase,1121
SARO_RS09665,Saro_1928,2040075,2041508,sigma-54-dependent Fis family transcriptional regulator,1433
SARO_RS09670,Saro_1929,2041595,2043823,two-component sensor histidine kinase,2228
SARO_RS09675,Saro_1930,2043837,2045222,sigma-54-dependent Fis family transcriptional regulator,1385
SARO_RS09680,NA,2045402,2045983,RNA chaperone Hfq,581
SARO_RS09685,Saro_1932,2045980,2047329,GTPase HflX,1349
SARO_RS09690,Saro_1933,2047316,2048140,nucleoside triphosphate pyrophosphohydrolase,824
SARO_RS09695,Saro_1934,2048323,2049489,integrase,1166
SARO_RS09700,Saro_1935,2049480,2051612,integrase,2132
SARO_RS09705,Saro_1936,2051609,2052088,hypothetical protein,479
SARO_RS09710,Saro_1937,2052456,2053223,MBL fold metallo-hydrolase,767
SARO_RS09715,Saro_1938,2053220,2053996,TatD family deoxyribonuclease,776
SARO_RS09720,Saro_1939,2053996,2055561,methionine--tRNA ligase,1565
SARO_RS09725,Saro_1940,2055596,2056552,DNA polymerase III subunit delta',956
SARO_RS09730,Saro_1941,2056549,2057178,dTMP kinase,629
SARO_RS09735,Saro_1942,2057175,2058302,D-alanyl-D-alanine carboxypeptidase,1127
SARO_RS09740,Saro_1943,2058390,2059301,sporulation-like protein,911
SARO_RS09745,Saro_1944,2059285,2060331,lytic murein transglycosylase,1046
SARO_RS09755,Saro_1945,2060883,2062295,dihydrolipoyl dehydrogenase,1412
SARO_RS09760,Saro_1946,2062376,2063659,pyruvate dehydrogenase complex dihydrolipoamide acetyltransferase,1283
SARO_RS09765,Saro_1947,2063832,2064290,universal stress protein,458
SARO_RS09770,Saro_1948,2064303,2066582,ribonuclease R,2279
SARO_RS09775,Saro_1949,2066623,2067942,peptidase M28,1319
SARO_RS09780,Saro_1950,2068026,2069573,proline--tRNA ligase,1547
SARO_RS09785,Saro_1951,2069644,2070198,polyhydroxyalkanoate synthesis repressor PhaR,554
SARO_RS09790,Saro_1952,2070281,2071351,alanine racemase,1070
SARO_RS09795,Saro_1953,2071344,2072978,MFS transporter,1634
SARO_RS09800,Saro_1954,2073050,2073433,Fe-S cluster protein,383
SARO_RS09805,Saro_1955,2073483,2074037,colicin V production protein,554
SARO_RS09810,Saro_1956,2074050,2075417,DNA repair protein RadA,1367
SARO_RS09820,Saro_1957,2075694,2076518,inositol monophosphatase,824
SARO_RS09825,Saro_1958,2076522,2077085,elongation factor P,563
SARO_RS09830,Saro_1959,2077196,2077585,hypothetical protein,389
SARO_RS09835,Saro_1960,2077582,2079534,oligopeptide transporter%2C OPT family,1952
SARO_RS09840,Saro_1961,2079602,2080741,murein L%2CD-transpeptidase,1139
SARO_RS09845,Saro_1962,2080800,2081441,thiamine phosphate synthase,641
SARO_RS09850,NA,2081521,2081886,hypothetical protein,365
SARO_RS09855,Saro_1964,2081972,2082877,fructose bisphosphate aldolase,905
SARO_RS09860,Saro_1965,2083063,2084250,phosphoglycerate kinase,1187
SARO_RS09865,Saro_1966,2084247,2084717,MOSC domain-containing protein,470
SARO_RS09870,Saro_1967,2084730,2085737,type I glyceraldehyde-3-phosphate dehydrogenase,1007
SARO_RS09875,Saro_1968,2085758,2087725,transketolase,1967
SARO_RS09880,NA,2087938,2088156,hypothetical protein,218
SARO_RS09885,Saro_1970,2088167,2088505,cell division protein ZapA,338
SARO_RS09890,Saro_1971,2088711,2089298,5-formyltetrahydrofolate cyclo-ligase,587
SARO_RS09895,Saro_1972,2089295,2089513,DUF2842 domain-containing protein,218
SARO_RS09910,Saro_1973,2090151,2090723,hypothetical protein,572
SARO_RS09915,Saro_1974,2090753,2092093,2-oxo acid dehydrogenase subunit E2,1340
SARO_RS09920,Saro_1975,2092097,2093152,alpha-ketoacid dehydrogenase subunit beta,1055
SARO_RS09925,Saro_1976,2093149,2094447,3-methyl-2-oxobutanoate dehydrogenase (2-methylpropanoyl-transferring) subunit alpha,1298
SARO_RS09930,Saro_1977,2094575,2095519,thymidylate synthase,944
SARO_RS20665,Saro_1978,2095748,2096539,hypothetical protein,791
SARO_RS09945,Saro_1979,2096600,2098657,ATP-dependent DNA helicase RecG,2057
SARO_RS09950,Saro_1980,2098709,2099254,hypothetical protein,545
SARO_RS09955,Saro_1981,2099370,2099651,succinate dehydrogenase assembly factor 2,281
SARO_RS09960,Saro_1982,2099682,2103176,transcription-repair coupling factor,3494
SARO_RS09965,Saro_1983,2103173,2104465,GGDEF domain-containing protein,1292
SARO_RS09970,Saro_1984,2104598,2105383,NAD kinase,785
SARO_RS09980,Saro_1985,2105829,2106023,hypothetical protein,194
SARO_RS09985,NA,2106020,2106343,hypothetical protein,323
SARO_RS09990,Saro_1987,2106466,2109585,CHAT domain-containing protein,3119
SARO_RS09995,Saro_1988,2109582,2117444,hypothetical protein,7862
SARO_RS10000,Saro_1989,2117429,2119192,ShlB/FhaC/HecB family hemolysin secretion/activation protein,1763
SARO_RS10005,Saro_1990,2119388,2122123,protein translocase subunit SecA,2735
SARO_RS10010,Saro_1991,2122230,2122496,hypothetical protein,266
SARO_RS20235,Saro_1992,2122548,2123156,energy transducer TonB,608
SARO_RS10020,Saro_1993,2123244,2124470,bifunctional glutamate N-acetyltransferase/amino-acid acetyltransferase ArgJ,1226
SARO_RS10025,Saro_1994,2124484,2125089,glutathione S-transferase,605
SARO_RS10030,Saro_1995,2125098,2125907,inositol monophosphatase,809
SARO_RS10035,Saro_1996,2125964,2126284,thioredoxin,320
SARO_RS10040,Saro_1997,2126345,2129830,double-strand break repair helicase AddA,3485
SARO_RS10045,Saro_1998,2129827,2132808,double-strand break repair protein AddB,2981
SARO_RS10050,Saro_1999,2132808,2133530,nucleotidyltransferase family protein,722
SARO_RS10055,Saro_2000,2133527,2134510,aminoglycoside phosphotransferase,983
SARO_RS10060,Saro_2001,2134501,2134950,tRNA (adenosine(37)-N6)-threonylcarbamoyltransferase complex ATPase subunit type 1 TsaE,449
SARO_RS10065,Saro_2002,2134947,2137295,two-component sensor histidine kinase,2348
SARO_RS10070,Saro_2003,2137479,2138903,adenosylhomocysteinase,1424
SARO_RS10075,Saro_2004,2139107,2139586,peroxiredoxin,479
SARO_RS10080,Saro_2005,2139629,2140384,porin,755
SARO_RS10085,Saro_2006,2140389,2140850,hypothetical protein,461
SARO_RS10090,Saro_2007,2140974,2141588,GTP cyclohydrolase I FolE,614
SARO_RS10095,Saro_2008,2141605,2143119,phospholipase,1514
SARO_RS10100,Saro_2009,2143262,2144029,class I SAM-dependent methyltransferase,767
SARO_RS10105,Saro_2010,2144010,2144318,septum formation initiator,308
SARO_RS10115,Saro_2011,2144540,2145019,DUF1178 domain-containing protein,479
SARO_RS10120,Saro_2012,2145016,2145861,carbon-nitrogen hydrolase family protein,845
SARO_RS10125,Saro_2013,2145858,2146115,glutaredoxin 3,257
SARO_RS10130,Saro_2014,2146285,2146746,heat-shock protein,461
SARO_RS10135,Saro_2015,2146923,2148500,ABC transporter ATP-binding protein,1577
SARO_RS10140,Saro_2016,2148509,2149198,Crp/Fnr family transcriptional regulator,689
SARO_RS10145,Saro_2017,2149283,2150914,CTP synthetase,1631
SARO_RS10150,Saro_2018,2151067,2151456,preprotein translocase subunit SecG,389
SARO_RS10155,Saro_2019,2151568,2152338,triose-phosphate isomerase,770
SARO_RS10160,Saro_2020,2152601,2154541,hypothetical protein,1940
SARO_RS10165,Saro_2021,2154555,2156090,anthranilate synthase component I,1535
SARO_RS10170,Saro_2022,2156087,2156674,type 1 glutamine amidotransferase,587
SARO_RS10175,Saro_2023,2156671,2157663,anthranilate phosphoribosyltransferase,992
SARO_RS10180,Saro_2024,2157759,2158547,indole-3-glycerol-phosphate synthase,788
SARO_RS10185,Saro_2025,2158544,2159749,serine hydrolase,1205
SARO_RS10190,Saro_2026,2159925,2160737,NYN domain-containing protein,812
SARO_RS10195,Saro_2027,2160981,2161454,cyclic pyranopterin monophosphate synthase MoaC,473
SARO_RS10200,Saro_2028,2161451,2162656,molybdopterin molybdenumtransferase MoeA,1205
SARO_RS10205,Saro_2029,2162774,2163478,LexA repressor,704
SARO_RS10210,Saro_2030,2163622,2165904,DUF4131 domain-containing protein,2282
SARO_RS10215,Saro_2031,2165934,2167397,glutamate--tRNA ligase,1463
SARO_RS10220,Saro_2032,2167442,2168728,citrate synthase,1286
SARO_RS10225,Saro_2033,2168860,2169045,hypothetical protein,185
SARO_RS10230,Saro_2034,2169049,2170425,sensor histidine kinase,1376
SARO_RS10235,Saro_2035,2170427,2171383,hypothetical protein,956
SARO_RS10240,Saro_2036,2171393,2172637,hypothetical protein,1244
SARO_RS10245,Saro_2037,2172713,2173012,hypothetical protein,299
SARO_RS10250,Saro_2038,2173084,2175678,hypothetical protein,2594
SARO_RS10255,Saro_2039,2175675,2177105,uracil-DNA glycosylase,1430
SARO_RS10260,Saro_2040,2177102,2178367,putative DNA modification/repair radical SAM protein,1265
SARO_RS10265,Saro_2041,2178653,2179135,general stress protein,482
SARO_RS10270,Saro_2042,2179236,2180813,amino acid permease,1577
SARO_RS10275,Saro_2043,2181011,2181880,3-methyl-2-oxobutanoate hydroxymethyltransferase,869
SARO_RS10280,Saro_2044,2181960,2183027,DUF475 domain-containing protein,1067
SARO_RS10285,Saro_2045,2183030,2184097,CoA transferase,1067
SARO_RS10290,Saro_2046,2184172,2185773,hypothetical protein,1601
SARO_RS10295,Saro_2047,2185739,2187115,PEP-CTERM-box response regulator transcription factor,1376
SARO_RS10300,Saro_2048,2187115,2189250,PEP-CTERM system histidine kinase PrsK,2135
SARO_RS10305,Saro_2049,2189261,2190646,sugar transferase,1385
SARO_RS10310,Saro_2050,2190847,2191086,hypothetical protein,239
SARO_RS10315,Saro_2051,2191248,2193557,DUF3376 domain-containing protein,2309
SARO_RS10320,Saro_2052,2193628,2194191,cytochrome b561,563
SARO_RS10325,Saro_2053,2194213,2195349,molecular chaperone DnaJ,1136
SARO_RS10330,Saro_2054,2195435,2197342,molecular chaperone DnaK,1907
SARO_RS10335,Saro_2055,2197510,2198055,copper chaperone PCu(A)C,545
SARO_RS10340,NA,2198052,2198576,hypothetical protein,524
SARO_RS10345,Saro_2057,2198561,2198818,hypothetical protein,257
SARO_RS10350,Saro_2058,2198985,2199662,cysteine hydrolase,677
SARO_RS10355,Saro_2059,2199768,2200328,nucleotide exchange factor GrpE,560
SARO_RS10360,Saro_2060,2200325,2201389,HrcA family transcriptional regulator,1064
SARO_RS10365,Saro_2061,2201469,2202182,ribonuclease PH,713
SARO_RS10370,Saro_2062,2202182,2202811,non-canonical purine NTP pyrophosphatase%2C RdgB/HAM1 family,629
SARO_RS10375,Saro_2063,2202886,2204040,radical SAM protein,1154
SARO_RS10380,Saro_2064,2204037,2204930,tyrosine recombinase XerC,893
SARO_RS10385,Saro_2065,2204941,2206272,sensor histidine kinase,1331
SARO_RS10390,Saro_2066,2206348,2207025,DNA-binding response regulator,677
SARO_RS10395,Saro_2067,2207142,2207441,hypothetical protein,299
SARO_RS10400,Saro_2068,2207602,2209398,elongation factor 3,1796
SARO_RS10405,Saro_2069,2209399,2209872,hypothetical protein,473
SARO_RS10410,Saro_2070,2209989,2210561,XRE family transcriptional regulator,572
SARO_RS10415,Saro_2071,2210455,2211738,glycosyltransferase family 4 protein,1283
SARO_RS10420,Saro_2072,2211779,2212756,protein translocase subunit SecF,977
SARO_RS10425,Saro_2073,2212771,2214378,protein translocase subunit SecD,1607
SARO_RS10430,Saro_2074,2214406,2214813,preprotein translocase subunit YajC,407
SARO_RS10440,Saro_2075,2215158,2215571,hypothetical protein,413
SARO_RS10445,Saro_2076,2215628,2216014,hypothetical protein,386
SARO_RS10450,Saro_2077,2216103,2216555,type II 3-dehydroquinate dehydratase,452
SARO_RS10455,Saro_2078,2216655,2217143,acetyl-CoA carboxylase biotin carboxyl carrier protein,488
SARO_RS10460,Saro_2079,2217156,2218502,acetyl-CoA carboxylase biotin carboxylase subunit,1346
SARO_RS10465,Saro_2080,2218570,2219169,DedA family protein,599
SARO_RS10470,Saro_2081,2219246,2220193,glutathione synthase,947
SARO_RS10475,Saro_2082,2220307,2220513,hypothetical protein,206
SARO_RS10480,Saro_2083,2220539,2220895,hypothetical protein,356
SARO_RS10485,Saro_2084,2220892,2221728,16S rRNA (cytidine(1402)-2'-O)-methyltransferase,836
SARO_RS10490,Saro_2085,2221784,2222962,penicillin-binding protein activator,1178
SARO_RS10495,Saro_2086,2223045,2225045,DNA topoisomerase IV subunit B,2000
SARO_RS10500,Saro_2087,2225196,2225486,type II toxin-antitoxin system RelE/ParE family toxin,290
SARO_RS10505,Saro_2088,2225476,2225733,type II toxin-antitoxin system ParD family antitoxin,257
SARO_RS10515,Saro_2090,2226779,2227624,MoxR family ATPase,845
SARO_RS10520,Saro_2091,2227684,2228424,glutathione S-transferase family protein,740
SARO_RS10525,Saro_2092,2228520,2228942,aldehyde-activating protein,422
SARO_RS10530,Saro_2093,2228948,2230129,VWA domain-containing protein,1181
SARO_RS10535,Saro_2094,2230227,2231000,enoyl-CoA hydratase,773
SARO_RS10540,Saro_2096,2232472,2233047,hypothetical protein,575
SARO_RS10545,Saro_2097,2233152,2234426,MFS transporter,1274
SARO_RS10550,Saro_2098,2234649,2235851,DUF1343 domain-containing protein,1202
SARO_RS10555,Saro_2099,2235848,2236390,hypothetical protein,542
SARO_RS10560,Saro_2100,2236438,2237667,tyrosine--tRNA ligase,1229
SARO_RS10565,Saro_2101,2237799,2238137,pilus protein PilZ,338
SARO_RS10570,Saro_2102,2238258,2239541,MFS transporter,1283
SARO_RS10575,Saro_2103,2239574,2240491,cysteine synthase A,917
SARO_RS10580,Saro_2104,2240497,2241201,dienelactone hydrolase family protein,704
SARO_RS10585,Saro_2105,2241329,2243131,acyl-CoA dehydrogenase,1802
SARO_RS10590,Saro_2106,2243137,2243607,MerR family DNA-binding transcriptional regulator,470
SARO_RS10595,Saro_2107,2243640,2244023,phosphoribosyl-AMP cyclohydrolase,383
SARO_RS10600,Saro_2108,2244411,2245208,ComF family protein,797
SARO_RS10605,Saro_2109,2245284,2246075,methyltransferase domain-containing protein,791
SARO_RS10610,Saro_2110,2246098,2248761,pyruvate%2C phosphate dikinase,2663
SARO_RS10615,Saro_2111,2248829,2251045,glycine--tRNA ligase subunit beta,2216
SARO_RS10620,Saro_2112,2251230,2252135,glycine--tRNA ligase subunit alpha,905
SARO_RS10625,Saro_2113,2252270,2253178,TraB/GumN family protein,908
SARO_RS10630,Saro_2114,2253175,2254077,TraB/GumN family protein,902
SARO_RS10635,Saro_2115,2254216,2254830,50S ribosomal protein L25,614
SARO_RS10640,Saro_2116,2254975,2255550,peptidyl-tRNA hydrolase,575
SARO_RS10645,Saro_2117,2255695,2256108,PEP-CTERM sorting domain-containing protein,413
SARO_RS10650,Saro_2118,2256144,2257658,tetratricopeptide repeat protein,1514
SARO_RS10655,Saro_2119,2257832,2258548,PEP-CTERM sorting domain-containing protein,716
SARO_RS10660,Saro_2120,2258634,2260151,hypothetical protein,1517
SARO_RS10665,Saro_2121,2260265,2261365,redox-regulated ATPase YchF,1100
SARO_RS10670,Saro_2122,2261421,2261816,MerR family DNA-binding transcriptional regulator,395
SARO_RS10675,Saro_2123,2261861,2262658,glutaredoxin,797
SARO_RS10680,Saro_2124,2262722,2263513,DUF1206 domain-containing protein,791
SARO_RS10685,Saro_2125,2263557,2264015,MaoC family dehydratase,458
SARO_RS10690,Saro_2126,2264090,2264578,hypothetical protein,488
SARO_RS10695,Saro_2127,2264590,2266401,DNA mismatch repair endonuclease MutL,1811
SARO_RS10700,Saro_2128,2266590,2267636,rod shape-determining protein,1046
SARO_RS10705,Saro_2129,2267716,2268621,rod shape-determining protein MreC,905
SARO_RS10710,Saro_2130,2268618,2269172,rod shape-determining protein MreD,554
SARO_RS10715,Saro_2131,2269174,2271243,penicillin-binding protein 2,2069
SARO_RS10720,Saro_2132,2271243,2272358,rod shape-determining protein RodA,1115
SARO_RS10735,Saro_2133,2273318,2273746,metal-binding protein,428
SARO_RS10740,NA,2273874,2274074,hypothetical protein,200
SARO_RS10745,Saro_2135,2274494,2275549,copper resistance protein B,1055
SARO_RS10750,Saro_2136,2275546,2277300,copper resistance system multicopper oxidase,1754
SARO_RS10755,Saro_2137,2277362,2277931,RNA polymerase sigma factor,569
SARO_RS10760,Saro_2138,2277928,2278368,hypothetical protein,440
SARO_RS10765,Saro_2139,2278365,2278643,hypothetical protein,278
SARO_RS10770,Saro_2140,2278782,2279165,copper resistance protein C,383
SARO_RS10775,Saro_2141,2279170,2280102,copper resistance D,932
SARO_RS10780,Saro_2142,2280167,2282512,copper-translocating P-type ATPase,2345
SARO_RS10785,Saro_2143,2282509,2282712,DUF2933 domain-containing protein,203
SARO_RS10790,Saro_2144,2282709,2283098,Cu(I)-responsive transcriptional regulator,389
SARO_RS10795,Saro_2145,2283438,2285918,heavy metal translocating P-type ATPase,2480
SARO_RS10800,Saro_2146,2286002,2289253,CusA/CzcA family heavy metal efflux RND transporter,3251
SARO_RS10805,Saro_2147,2289255,2290436,efflux RND transporter periplasmic adaptor subunit,1181
SARO_RS10810,Saro_2148,2290448,2291650,TolC family protein,1202
SARO_RS10815,NA,2291652,2292110,hypothetical protein,458
SARO_RS10820,NA,2292174,2292515,hypothetical protein,341
SARO_RS10825,Saro_2150,2292560,2292910,DUF3703 domain-containing protein,350
SARO_RS10830,Saro_2151,2292907,2293533,cation transporter,626
SARO_RS10835,Saro_2152,2293603,2294016,MerR family DNA-binding transcriptional regulator,413
SARO_RS10840,Saro_2153,2294101,2294346,AlpA family phage regulatory protein,245
SARO_RS10845,Saro_2154,2294394,2294855,hypothetical protein,461
SARO_RS10850,Saro_2155,2295204,2295533,hypothetical protein,329
SARO_RS10855,Saro_2156,2295560,2295847,type IV conjugative transfer system protein TraL,287
SARO_RS10860,Saro_2157,2295859,2296431,conjugal transfer protein TraE,572
SARO_RS10865,Saro_2158,2296431,2297189,conjugal transfer protein TraK,758
SARO_RS10870,Saro_2159,2297182,2298522,conjugal transfer protein TraB,1340
SARO_RS10875,Saro_2160,2298519,2299433,thiol:disulfide interchange protein DsbC,914
SARO_RS10880,Saro_2161,2299438,2300247,conjugal transfer protein TraV,809
SARO_RS10885,Saro_2162,2300247,2302790,type IV secretion system protein TraC,2543
SARO_RS10890,Saro_2163,2302820,2303212,hypothetical protein,392
SARO_RS10895,Saro_2164,2303209,2303616,hypothetical protein,407
SARO_RS10900,Saro_2165,2303603,2304127,conjugal transfer protein TraF,524
SARO_RS10905,Saro_2166,2304124,2304771,type-F conjugative transfer system protein TraW,647
SARO_RS20670,Saro_2167,2304768,2305883,hypothetical protein,1115
SARO_RS10920,Saro_2168,2305885,2307321,conjugal transfer protein TraH,1436
SARO_RS10925,Saro_2169,2307355,2310057,conjugal transfer protein TraG,2702
SARO_RS10930,Saro_2170,2310068,2310298,hypothetical protein,230
SARO_RS10935,Saro_2171,2310400,2310762,hypothetical protein,362
SARO_RS10940,Saro_2172,2310734,2313502,DEAD/DEAH box helicase,2768
SARO_RS10945,Saro_2173,2313519,2316458,DUF1156 domain-containing protein,2939
SARO_RS10950,Saro_2174,2316468,2317040,DUF3780 domain-containing protein,572
SARO_RS10955,Saro_2175,2317040,2320144,DUF499 domain-containing protein,3104
SARO_RS10960,Saro_2176,2320276,2321145,WYL domain-containing protein,869
SARO_RS20675,Saro_2177,2321259,2321453,hypothetical protein,194
SARO_RS10965,Saro_2178,2321554,2322195,helix-turn-helix transcriptional regulator,641
SARO_RS20680,NA,2322208,2322633,hypothetical protein,425
SARO_RS10970,NA,2322630,2322932,hypothetical protein,302
SARO_RS10975,Saro_2180,2322932,2323129,hypothetical protein,197
SARO_RS10980,Saro_2181,2323154,2323393,hypothetical protein,239
SARO_RS10990,Saro_2184,2325969,2328365,conjugal transfer protein TraD,2396
SARO_RS10995,Saro_2185,2328355,2328687,hypothetical protein,332
SARO_RS11000,Saro_2187,2329126,2329320,hypothetical protein,194
SARO_RS11005,Saro_2188,2329423,2329659,hypothetical protein,236
SARO_RS11010,Saro_2189,2329845,2330213,hypothetical protein,368
SARO_RS11015,Saro_2190,2330329,2330718,single-stranded DNA-binding protein,389
SARO_RS11020,Saro_2191,2331079,2331507,hypothetical protein,428
SARO_RS11025,Saro_2192,2331518,2331979,hypothetical protein,461
SARO_RS11030,Saro_2193,2332102,2333055,DUF2493 domain-containing protein,953
SARO_RS11035,Saro_2194,2333356,2333778,hypothetical protein,422
SARO_RS11045,Saro_2196,2334380,2336281,RNA-directed DNA polymerase,1901
SARO_RS11055,Saro_2198,2337477,2339465,chromosome partitioning protein ParB,1988
SARO_RS11060,Saro_2199,2339884,2340771,DNA-processing protein DprA,887
SARO_RS11065,Saro_2200,2340764,2341417,hypothetical protein,653
SARO_RS11070,Saro_2201,2341420,2342457,DNA-processing protein DprA,1037
SARO_RS11075,Saro_2202,2342460,2343707,hypothetical protein,1247
SARO_RS11080,Saro_2203,2343959,2344807,ImmA/IrrE family metallo-endopeptidase,848
SARO_RS11085,Saro_2204,2344797,2345120,XRE family transcriptional regulator,323
SARO_RS20685,NA,2345253,2345471,hypothetical protein,218
SARO_RS11090,Saro_2205,2345529,2346557,hypothetical protein,1028
SARO_RS11095,NA,2346743,2347255,hypothetical protein,512
SARO_RS11100,NA,2347321,2348055,RES domain-containing protein,734
SARO_RS11105,NA,2348052,2348465,DUF2384 domain-containing protein,413
SARO_RS11110,Saro_2208,2348519,2352760,methylase,4241
SARO_RS11115,Saro_2209,2352836,2353732,virulence-associated protein E,896
SARO_RS11120,Saro_2210,2353857,2354513,lytic transglycosylase,656
SARO_RS11125,Saro_2211,2354601,2355872,site-specific integrase,1271
SARO_RS11130,Saro_2212,2356063,2356587,ATPase,524
SARO_RS11135,Saro_2213,2356571,2356927,ArsR family transcriptional regulator,356
SARO_RS11140,Saro_2214,2356909,2357391,hypothetical protein,482
SARO_RS11145,Saro_2215,2357459,2360374,TonB-dependent receptor,2915
SARO_RS11150,Saro_2216,2360752,2361171,6%2C7-dimethyl-8-ribityllumazine synthase,419
SARO_RS11155,Saro_2217,2361175,2361699,DUF1254 domain-containing protein,524
SARO_RS11160,Saro_2218,2361696,2362280,DUF1214 domain-containing protein,584
SARO_RS11165,Saro_2219,2362270,2363361,hypothetical protein,1091
SARO_RS11170,Saro_2220,2363361,2364449,hypothetical protein,1088
SARO_RS11175,Saro_2221,2364530,2364853,hypothetical protein,323
SARO_RS11180,Saro_2222,2365068,2365595,MarR family transcriptional regulator,527
SARO_RS11185,Saro_2223,2365698,2366984,enolase,1286
SARO_RS11190,Saro_2224,2367208,2367798,hypothetical protein,590
SARO_RS11195,Saro_2225,2367819,2368205,phage holin family protein,386
SARO_RS11200,Saro_2226,2368238,2368486,hypothetical protein,248
SARO_RS11205,Saro_2227,2368488,2368988,hypothetical protein,500
SARO_RS11210,Saro_2228,2369075,2369296,DUF4170 domain-containing protein,221
SARO_RS11215,Saro_2229,2369385,2369861,transcription elongation factor GreA,476
SARO_RS11220,Saro_2230,2369993,2373316,carbamoyl-phosphate synthase large subunit,3323
SARO_RS11225,Saro_2231,2373388,2374563,carbamoyl-phosphate synthase small subunit,1175
SARO_RS11230,Saro_2232,2374724,2375179,aspartyl-tRNA amidotransferase subunit B,455
SARO_RS11240,Saro_2234,2375707,2377572,DNA primase,1865
SARO_RS11245,Saro_2235,2377635,2379638,RNA polymerase sigma factor RpoD,2003
SARO_RS11250,Saro_2236,2379628,2380452,FkbM family methyltransferase,824
SARO_RS11255,Saro_2237,2380449,2380904,DUF3237 domain-containing protein,455
SARO_RS11260,Saro_2238,2380901,2382193,flavin-dependent oxidoreductase,1292
SARO_RS11265,Saro_2239,2382411,2382848,ribose 5-phosphate isomerase B,437
SARO_RS11270,Saro_2240,2382863,2384173,serine hydroxymethyltransferase,1310
SARO_RS11275,Saro_2241,2384177,2384383,hypothetical protein,206
SARO_RS11280,Saro_2242,2384388,2384867,transcriptional regulator NrdR,479
SARO_RS11285,Saro_2243,2384860,2385615,rRNA methyltransferase,755
SARO_RS11290,NA,2385612,2385899,hypothetical protein,287
SARO_RS11295,Saro_2245,2386109,2386720,30S ribosomal protein S4,611
SARO_RS11300,Saro_2246,2386847,2387065,hypothetical protein,218
SARO_RS11305,Saro_2247,2387062,2388186,tRNA guanosine(34) transglycosylase Tgt,1124
SARO_RS11310,Saro_2248,2388250,2389020,hypothetical protein,770
SARO_RS11315,Saro_2249,2389017,2390207,cytochrome P450,1190
SARO_RS11320,Saro_2250,2390270,2391298,tRNA preQ1(34) S-adenosylmethionine ribosyltransferase-isomerase QueA,1028
SARO_RS11325,Saro_2251,2391325,2392023,peptidylprolyl isomerase,698
SARO_RS11330,Saro_2252,2392122,2392634,pantetheine-phosphate adenylyltransferase,512
SARO_RS11335,Saro_2253,2392634,2393545,polyprenyl synthetase family protein,911
SARO_RS11340,Saro_2254,2393557,2393808,exodeoxyribonuclease 7 small subunit,251
SARO_RS11345,Saro_2255,2393882,2394280,DUF2177 domain-containing protein,398
SARO_RS11350,Saro_2256,2394320,2396479,phosphoribosylformylglycinamidine synthase subunit PurL,2159
SARO_RS11355,Saro_2257,2396536,2397342,hypothetical protein,806
SARO_RS11360,NA,2397458,2398069,hypothetical protein,611
SARO_RS11365,Saro_2259,2398070,2398954,phosphoserine phosphatase SerB,884
SARO_RS11370,Saro_2260,2398947,2399921,tRNA (adenosine(37)-N6)-dimethylallyltransferase MiaA,974
SARO_RS11375,Saro_2261,2400108,2401856,acetolactate synthase%2C large subunit%2C biosynthetic type,1748
SARO_RS11380,Saro_2262,2401874,2402389,acetolactate synthase small subunit,515
SARO_RS11385,Saro_2263,2402518,2403585,ketol-acid reductoisomerase,1067
SARO_RS20240,Saro_2264,2403807,2404073,hypothetical protein,266
SARO_RS11395,Saro_2265,2404152,2404811,polyisoprenoid-binding protein,659
SARO_RS11400,Saro_2266,2404816,2405949,epoxide hydrolase,1133
SARO_RS11405,Saro_2267,2406158,2407828,2-isopropylmalate synthase,1670
SARO_RS11410,Saro_2268,2407965,2409011,amidohydrolase,1046
SARO_RS11415,Saro_2269,2409090,2410085,nitronate monooxygenase,995
SARO_RS11420,NA,2410112,2410615,hypothetical protein,503
SARO_RS11425,Saro_2271,2410645,2411391,hypothetical protein,746
SARO_RS11430,Saro_2272,2411490,2411978,flavodoxin family protein,488
SARO_RS11435,Saro_2273,2411985,2413355,hypothetical protein,1370
SARO_RS11440,Saro_2274,2413410,2415197,single-stranded-DNA-specific exonuclease RecJ,1787
SARO_RS11455,Saro_2275,2415703,2416887,two-component sensor histidine kinase,1184
SARO_RS11460,Saro_2276,2416941,2418002,phosphate ABC transporter substrate-binding protein,1061
SARO_RS11465,Saro_2277,2418021,2419403,phosphate ABC transporter permease subunit PstC,1382
SARO_RS11470,Saro_2278,2419411,2420697,phosphate ABC transporter%2C permease protein PstA,1286
SARO_RS11475,Saro_2279,2420726,2421526,phosphate ABC transporter ATP-binding protein,800
SARO_RS11480,Saro_2280,2421536,2422222,phosphate transport system regulatory protein PhoU,686
SARO_RS11485,Saro_2281,2422368,2423057,phosphate regulon transcriptional regulatory protein PhoB,689
SARO_RS11490,Saro_2282,2423106,2424662,hypothetical protein,1556
SARO_RS11495,Saro_2283,2424614,2424886,DUF1467 domain-containing protein,272
SARO_RS11500,Saro_2284,2424892,2426544,MBL fold metallo-hydrolase,1652
SARO_RS11505,Saro_2285,2426541,2427323,type III pantothenate kinase,782
SARO_RS11510,Saro_2286,2427307,2428074,biotin--[acetyl-CoA-carboxylase] ligase,767
SARO_RS11515,Saro_2287,2428043,2429506,NADH-quinone oxidoreductase subunit NuoN,1463
SARO_RS11520,Saro_2288,2429506,2431056,NADH-quinone oxidoreductase subunit M,1550
SARO_RS11525,Saro_2289,2431053,2433122,NADH-quinone oxidoreductase subunit L,2069
SARO_RS11530,Saro_2290,2433132,2433437,NADH-quinone oxidoreductase subunit NuoK,305
SARO_RS11535,Saro_2291,2433437,2434054,NADH-quinone oxidoreductase subunit J,617
SARO_RS11540,Saro_2292,2434082,2434567,NADH-quinone oxidoreductase subunit I,485
SARO_RS11545,Saro_2293,2434564,2435607,NADH-quinone oxidoreductase subunit H,1043
SARO_RS11550,Saro_2294,2435747,2437756,NADH-quinone oxidoreductase subunit G,2009
SARO_RS11555,Saro_2295,2437874,2439160,NADH-quinone oxidoreductase subunit NuoF,1286
SARO_RS11560,Saro_2296,2439162,2439830,NAD(P)H-dependent oxidoreductase subunit E,668
SARO_RS11565,Saro_2297,2439823,2440020,hypothetical protein,197
SARO_RS11570,Saro_2298,2440017,2440232,hypothetical protein,215
SARO_RS11575,Saro_2299,2440229,2440579,DUF4440 domain-containing protein,350
SARO_RS11580,Saro_2300,2440576,2441787,NADH-quinone oxidoreductase subunit D,1211
SARO_RS11585,Saro_2301,2441936,2442865,NADH-quinone oxidoreductase subunit C,929
SARO_RS11590,Saro_2302,2442879,2443424,NADH-quinone oxidoreductase subunit B,545
SARO_RS11595,Saro_2303,2443430,2443816,NADH-quinone oxidoreductase subunit A,386
SARO_RS11600,Saro_2304,2443979,2445385,coniferyl aldehyde dehydrogenase,1406
SARO_RS11605,Saro_2305,2445429,2446217,prepilin peptidase,788
SARO_RS11610,Saro_2306,2446328,2447524,acetyl-CoA C-acyltransferase,1196
SARO_RS11615,Saro_2307,2447597,2448118,hypothetical protein,521
SARO_RS11620,Saro_2308,2448208,2449227,D-glycerate dehydrogenase,1019
SARO_RS11625,Saro_2309,2449396,2450709,ammonium transporter,1313
SARO_RS20245,Saro_2310,2450763,2451269,YkgJ family cysteine cluster protein,506
SARO_RS11635,Saro_2311,2451632,2452210,hypothetical protein,578
SARO_RS11640,Saro_2312,2452218,2453627,2-nitropropane dioxygenase,1409
SARO_RS11645,Saro_2313,2453627,2454385,class I SAM-dependent methyltransferase,758
SARO_RS11650,Saro_2314,2454382,2455509,peptide chain release factor 2,1127
SARO_RS11655,Saro_2315,2455619,2456173,peroxiredoxin,554
SARO_RS11660,Saro_2316,2456270,2458804,penicillin-binding protein,2534
SARO_RS11665,Saro_2317,2458867,2459832,N-acetylmuramoyl-L-alanine amidase,965
SARO_RS11670,Saro_2318,2460343,2463150,ribonuclease E/G,2807
SARO_RS11675,Saro_2319,2463215,2463847,class I SAM-dependent methyltransferase,632
SARO_RS11680,Saro_2320,2463922,2465049,ThuA domain-containing protein,1127
SARO_RS11685,Saro_2321,2465491,2466180,hypothetical protein,689
SARO_RS11690,Saro_2322,2466404,2467186,succinate dehydrogenase iron-sulfur subunit,782
SARO_RS11695,Saro_2323,2467191,2467655,PaaI family thioesterase,464
SARO_RS11700,Saro_2324,2467652,2468785,cell division protein ZapE,1133
SARO_RS11705,NA,2469082,2470308,EAL domain-containing protein,1226
SARO_RS11710,Saro_2327,2471447,2473336,amidotransferase 1%2C exosortase A system-associated,1889
SARO_RS11715,Saro_2328,2473346,2474860,exosortase A,1514
SARO_RS11720,Saro_2329,2474901,2476133,glycosyl transferase family 1,1232
SARO_RS11725,Saro_2330,2476130,2477185,peptidoglycan bridge formation glycyltransferase FemA/FemB family protein,1055
SARO_RS11730,Saro_2331,2477182,2478063,polysaccharide deacetylase family protein,881
SARO_RS11735,Saro_2332,2478089,2479357,general secretion pathway protein,1268
SARO_RS11740,Saro_2333,2479376,2481082,hypothetical protein,1706
SARO_RS11745,Saro_2334,2481079,2481999,capsular polysaccharide biosynthesis protein,920
SARO_RS11750,Saro_2335,2482011,2483528,chain-length determining protein,1517
SARO_RS11755,Saro_2336,2483554,2484201,sugar ABC transporter substrate-binding protein,647
SARO_RS11760,Saro_2337,2484413,2485639,pyridoxal-dependent decarboxylase%2C exosortase A system-associated,1226
SARO_RS11765,Saro_2338,2485636,2487165,acyl-CoA ligase (AMP-forming)%2C exosortase A system-associated,1529
SARO_RS11770,Saro_2339,2487195,2488199,GNAT family N-acetyltransferase,1004
SARO_RS11775,Saro_2340,2488259,2488516,acyl carrier protein,257
SARO_RS11780,Saro_2341,2488513,2489184,hypothetical protein,671
SARO_RS11785,Saro_2342,2489181,2489969,hydrolase 1%2C exosortase A system-associated,788
SARO_RS11790,Saro_2343,2489959,2490927,thioredoxin-disulfide reductase,968
SARO_RS11795,Saro_2344,2491066,2491854,protein-tyrosine-phosphatase,788
SARO_RS11800,Saro_2345,2491959,2492348,response regulator receiver domain-containing protein,389
SARO_RS11805,Saro_2346,2492345,2493439,PAS domain-containing protein,1094
SARO_RS11810,Saro_2347,2493513,2493947,thioesterase,434
SARO_RS11815,Saro_2348,2493944,2495143,amidohydrolase,1199
SARO_RS11820,Saro_2349,2495287,2496534,acetyl-CoA C-acyltransferase,1247
SARO_RS11825,Saro_2350,2496607,2497944,peptidase M28 family protein,1337
SARO_RS11830,Saro_2351,2498081,2499760,energy-dependent translational throttle protein EttA,1679
SARO_RS11835,Saro_2352,2499782,2500261,hypothetical protein,479
SARO_RS11840,Saro_2353,2500567,2501571,hypothetical protein,1004
SARO_RS11845,NA,2501665,2502000,MarR family transcriptional regulator,335
SARO_RS11850,Saro_2355,2502186,2502959,2OG-Fe(II) oxygenase,773
SARO_RS11855,Saro_2356,2502950,2504809,DUF885 domain-containing protein,1859
SARO_RS11860,Saro_2357,2504873,2505280,DUF350 domain-containing protein,407
SARO_RS11865,Saro_2358,2505304,2505699,hypothetical protein,395
SARO_RS11870,Saro_2359,2505703,2506848,glutathionylspermidine synthase family protein,1145
SARO_RS11875,Saro_2360,2506853,2508457,lysine--tRNA ligase,1604
SARO_RS11880,Saro_2361,2508639,2509622,flagellin,983
SARO_RS11885,Saro_2362,2509800,2512523,ATP-dependent DNA helicase,2723
SARO_RS11890,Saro_2363,2512520,2513065,histidine phosphatase family protein,545
SARO_RS11895,Saro_2364,2513062,2513517,MerR family transcriptional regulator,455
SARO_RS11900,Saro_2365,2513528,2513806,integration host factor subunit alpha,278
SARO_RS11905,Saro_2366,2513945,2514922,3-oxoacyl-ACP synthase III,977
SARO_RS11910,Saro_2367,2514919,2516013,phosphate acyltransferase,1094
SARO_RS11915,Saro_2368,2516040,2516219,50S ribosomal protein L32,179
SARO_RS11920,Saro_2369,2516463,2516855,MAPEG family protein,392
SARO_RS11925,Saro_2370,2516920,2517657,MBL fold metallo-hydrolase,737
SARO_RS11930,Saro_2371,2517870,2518571,transcriptional regulator,701
SARO_RS11935,Saro_2372,2518688,2518876,hypothetical protein,188
SARO_RS11940,Saro_2373,2518866,2519243,hypothetical protein,377
SARO_RS11945,Saro_2374,2519335,2523933,hypothetical protein,4598
SARO_RS11950,Saro_2375,2523933,2525951,hypothetical protein,2018
SARO_RS11955,Saro_2376,2525951,2527939,hypothetical protein,1988
SARO_RS11960,Saro_2377,2527939,2529354,hypothetical protein,1415
SARO_RS11965,Saro_2378,2529536,2530972,aldehyde dehydrogenase,1436
SARO_RS11970,Saro_2379,2531046,2532701,acetolactate synthase large subunit,1655
SARO_RS11975,Saro_2380,2532877,2533800,D-2-hydroxyacid dehydrogenase,923
SARO_RS11980,Saro_2381,2533879,2535360,cysteine--tRNA ligase,1481
SARO_RS20250,Saro_2382,2535399,2544818,hypothetical protein,9419
SARO_RS11990,Saro_2383,2544608,2546482,ShlB/FhaC/HecB family hemolysin secretion/activation protein,1874
SARO_RS11995,Saro_2384,2546598,2547353,hypothetical protein,755
SARO_RS12000,Saro_2385,2547384,2548106,hypothetical protein,722
SARO_RS12005,Saro_2386,2548153,2550198,adenylate/guanylate cyclase domain-containing protein,2045
SARO_RS12010,Saro_2387,2550202,2553357,CHAT domain-containing protein,3155
SARO_RS12015,Saro_2388,2553517,2554197,NADH dehydrogenase,680
SARO_RS12020,Saro_2389,2554241,2556055,cobaltochelatase subunit CobT,1814
SARO_RS12025,Saro_2390,2556130,2556783,transaldolase,653
SARO_RS12030,Saro_2391,2556909,2557592,DUF4197 domain-containing protein,683
SARO_RS12035,Saro_2392,2557710,2558402,DUF4197 domain-containing protein,692
SARO_RS12040,Saro_2393,2558451,2560652,primosomal protein N',2201
SARO_RS12045,Saro_2394,2560701,2562269,deoxyribodipyrimidine photo-lyase,1568
SARO_RS12050,Saro_2395,2562266,2563135,CPBP family intramembrane metalloprotease,869
SARO_RS12055,Saro_2396,2563138,2564169,bifunctional DNA-binding transcriptional regulator/O6-methylguanine-DNA methyltransferase Ada,1031
SARO_RS12060,Saro_2397,2564166,2564648,DUF1203 domain-containing protein,482
SARO_RS12065,Saro_2398,2564747,2566306,serine protease,1559
SARO_RS12070,Saro_2399,2566475,2567029,F0F1 ATP synthase subunit delta,554
SARO_RS12075,Saro_2400,2567075,2568604,ATP synthase subunit alpha,1529
SARO_RS12080,Saro_2401,2568929,2569801,ATP synthase subunit gamma,872
SARO_RS12085,Saro_2402,2569866,2571311,ATP synthase subunit beta,1445
SARO_RS12090,Saro_2403,2571460,2571717,ATP synthase epsilon chain,257
SARO_RS12095,Saro_2404,2571954,2573342,aminomethyl transferase family protein,1388
SARO_RS12100,Saro_2405,2573603,2574442,beta-1%2C3-glucanase,839
SARO_RS12105,Saro_2406,2574470,2575483,twin-arginine translocation pathway signal protein,1013
SARO_RS12110,Saro_2407,2575480,2576235,IclR family transcriptional regulator,755
SARO_RS12115,Saro_2408,2576232,2576624,nuclear transport factor 2 family protein,392
SARO_RS12120,Saro_2409,2576621,2577754,enterotoxin,1133
SARO_RS12125,Saro_2410,2578324,2581104,TonB-dependent receptor,2780
SARO_RS12130,Saro_2411,2581270,2583744,twin-arginine translocation pathway signal protein,2474
SARO_RS12135,Saro_2412,2583756,2585444,PTS N-acetylglucosamine IIBC component,1688
SARO_RS12140,Saro_2413,2585441,2587951,phosphoenolpyruvate--protein phosphotransferase,2510
SARO_RS12145,Saro_2414,2588004,2589146,N-acetylglucosamine-6-phosphate deacetylase,1142
SARO_RS12150,Saro_2415,2589143,2590183,SIS domain-containing protein,1040
SARO_RS12155,Saro_2416,2590210,2590950,GntR family transcriptional regulator,740
SARO_RS12160,NA,2591073,2591285,hypothetical protein,212
SARO_RS12165,Saro_2417,2591327,2593792,beta-hexosaminidase,2465
SARO_RS12170,Saro_2418,2593840,2596416,beta-mannosidase,2576
SARO_RS12175,Saro_2419,2596413,2598962,glycoside hydrolase family 3,2549
SARO_RS12180,Saro_2420,2598959,2600401,metal-independent alpha-mannosidase,1442
SARO_RS12185,Saro_2421,2600398,2602707,alpha-1%2C2-mannosidase,2309
SARO_RS12190,Saro_2422,2602704,2604977,hypothetical protein,2273
SARO_RS12195,Saro_2423,2604974,2606890,alpha-L-fucosidase,1916
SARO_RS12200,Saro_2424,2606887,2609781,DUF4982 domain-containing protein,2894
SARO_RS12205,Saro_2425,2609778,2610539,hypothetical protein,761
SARO_RS12210,Saro_2426,2610554,2611399,FAA hydrolase family protein,845
SARO_RS12215,Saro_2427,2611396,2611743,L-rhamnose mutarotase,347
SARO_RS12220,Saro_2428,2611746,2613047,L-fucose:H+ symporter permease,1301
SARO_RS12225,Saro_2429,2613078,2613818,NAD(P)-dependent oxidoreductase,740
SARO_RS12230,Saro_2430,2613829,2615037,hydrolase,1208
SARO_RS12235,Saro_2431,2615034,2615363,D-galactarate dehydratase/Altronate hydrolase,329
SARO_RS12240,Saro_2432,2615344,2616177,amidohydrolase,833
SARO_RS12245,Saro_2433,2616174,2617163,aldo/keto reductase,989
SARO_RS12250,Saro_2434,2617282,2618100,IclR family transcriptional regulator,818
SARO_RS12255,Saro_2435,2618189,2619034,AraC family transcriptional regulator,845
SARO_RS12260,Saro_2436,2619147,2620316,4-hydroxybenzoate 3-monooxygenase,1169
SARO_RS12265,Saro_2437,2620391,2621065,DNA-binding response regulator,674
SARO_RS12270,Saro_2438,2621275,2623953,TonB-dependent receptor,2678
SARO_RS12275,Saro_2439,2624046,2625635,hypothetical protein,1589
SARO_RS12280,Saro_2440,2625899,2626285,hypothetical protein,386
SARO_RS12285,Saro_2441,2626298,2627761,glycerol kinase,1463
SARO_RS12290,Saro_2442,2627754,2629262,glycerol-3-phosphate dehydrogenase,1508
SARO_RS12295,Saro_2443,2629276,2630364,LLM class flavin-dependent oxidoreductase,1088
SARO_RS12300,Saro_2444,2630492,2631406,aldo/keto reductase,914
SARO_RS12305,Saro_2445,2631403,2632416,LacI family DNA-binding transcriptional regulator,1013
SARO_RS12310,Saro_2446,2632413,2634422,alpha-glucosidase,2009
SARO_RS12315,Saro_2447,2634603,2636954,TonB-dependent receptor,2351
SARO_RS12320,Saro_2448,2637286,2638515,MFS transporter,1229
SARO_RS12325,Saro_2449,2638634,2639713,putative sulfate exporter family transporter,1079
SARO_RS12330,Saro_2450,2639757,2640728,NADPH:quinone oxidoreductase family protein,971
SARO_RS12335,Saro_2451,2640725,2641969,cytochrome P450,1244
SARO_RS12340,Saro_2452,2642004,2643956,NAD(P)/FAD-dependent oxidoreductase,1952
SARO_RS12345,Saro_2453,2644059,2645693,ATP-dependent acyl-CoA ligase,1634
SARO_RS12350,Saro_2454,2645737,2646387,TetR/AcrR family transcriptional regulator,650
SARO_RS12355,Saro_2455,2646384,2647508,maleylacetate reductase,1124
SARO_RS12360,Saro_2456,2647738,2648964,CoA transferase,1226
SARO_RS12365,Saro_2457,2648961,2649866,MBL fold metallo-hydrolase,905
SARO_RS12370,Saro_2458,2649885,2652161,TonB-dependent receptor,2276
SARO_RS12375,Saro_2459,2652414,2653736,DUF3999 domain-containing protein,1322
SARO_RS12380,Saro_2460,2653733,2656567,DUF2339 domain-containing protein,2834
SARO_RS12385,Saro_2461,2656664,2657428,PAP2 family protein,764
SARO_RS12390,Saro_2462,2657679,2658371,VIT family protein,692
SARO_RS12395,Saro_2463,2658391,2659686,fumarylacetoacetase,1295
SARO_RS12400,Saro_2464,2659717,2660265,VOC family protein,548
SARO_RS12405,Saro_2465,2660381,2661277,LysR family transcriptional regulator,896
SARO_RS12410,Saro_2466,2661636,2662601,phosphatase PAP2 family protein,965
SARO_RS12415,Saro_2467,2662662,2663654,homocysteine S-methyltransferase,992
SARO_RS20255,Saro_2468,2663813,2664580,TetR/AcrR family transcriptional regulator,767
SARO_RS12425,Saro_2469,2664741,2667272,ligand-gated channel,2531
SARO_RS12430,Saro_2470,2667360,2669720,arylsulfatase,2360
SARO_RS12435,Saro_2471,2669717,2671183,DUF1254 domain-containing protein,1466
SARO_RS12440,Saro_2472,2671129,2672589,DUF1254 domain-containing protein,1460
SARO_RS12445,Saro_2473,2672670,2673440,3-oxoacyl-ACP reductase,770
SARO_RS12450,Saro_2474,2673496,2674410,formylglycine-generating enzyme family protein,914
SARO_RS12455,Saro_2475,2674487,2677174,DUF2309 domain-containing protein,2687
SARO_RS20260,Saro_2476,2677081,2678559,hypothetical protein,1478
SARO_RS12465,Saro_2477,2678583,2679455,LysR family transcriptional regulator,872
SARO_RS12475,Saro_2478,2679961,2680341,heat shock protein HspQ,380
SARO_RS12480,Saro_2479,2680366,2681244,multidrug ABC transporter permease,878
SARO_RS12485,Saro_2480,2681359,2682066,GcrA cell cycle regulator,707
SARO_RS12490,Saro_2481,2682188,2683312,GGDEF domain-containing protein,1124
SARO_RS12495,Saro_2482,2683433,2685751,polyribonucleotide nucleotidyltransferase,2318
SARO_RS12500,Saro_2483,2685914,2686183,30S ribosomal protein S15,269
SARO_RS12505,Saro_2484,2686189,2687103,tRNA pseudouridine(55) synthase TruB,914
SARO_RS12510,Saro_2485,2687106,2687765,site-2 protease family protein,659
SARO_RS12515,Saro_2486,2687810,2688364,N-acetyltransferase,554
SARO_RS12520,Saro_2487,2688361,2688939,thymidine kinase,578
SARO_RS12525,Saro_2488,2688951,2689358,ribosome-binding factor A,407
SARO_RS12530,Saro_2489,2689361,2689897,DUF1697 domain-containing protein,536
SARO_RS12535,Saro_2490,2690002,2692638,translation initiation factor IF-2,2636
SARO_RS12540,Saro_2491,2692635,2693369,DUF448 domain-containing protein,734
SARO_RS12545,Saro_2492,2693350,2694984,transcription termination/antitermination protein NusA,1634
SARO_RS12550,Saro_2493,2694988,2695548,ribosome maturation factor RimP,560
SARO_RS12555,Saro_2495,2696022,2696246,PspC domain-containing protein,224
SARO_RS12560,Saro_2496,2696315,2697040,membrane protein,725
SARO_RS12570,Saro_2497,2697274,2697939,pilus assembly protein TadE,665
SARO_RS12575,Saro_2498,2697939,2698520,pilus assembly protein,581
SARO_RS12580,Saro_2499,2698517,2700457,hypothetical protein,1940
SARO_RS20265,Saro_2500,2700925,2702313,hypothetical protein,1388
SARO_RS12595,Saro_2501,2702379,2703551,CoA transferase,1172
SARO_RS12600,Saro_2502,2703561,2705099,hypothetical protein,1538
SARO_RS12605,Saro_2503,2705109,2706542,aldehyde dehydrogenase,1433
SARO_RS12610,Saro_2504,2706568,2707683,NAD(P)-dependent alcohol dehydrogenase,1115
SARO_RS12615,Saro_2505,2707680,2709611,hypothetical protein,1931
SARO_RS12620,Saro_2506,2709608,2709922,hypothetical protein,314
SARO_RS12625,Saro_2507,2710035,2710988,LysR family transcriptional regulator,953
SARO_RS12630,Saro_2508,2710971,2712032,AraC family transcriptional regulator,1061
SARO_RS12635,Saro_2509,2712217,2714607,TonB-dependent receptor,2390
SARO_RS12640,Saro_2510,2714727,2715464,NAD(P)-dependent oxidoreductase,737
SARO_RS12645,Saro_2511,2715476,2716702,acyl-CoA dehydrogenase,1226
SARO_RS12650,Saro_2512,2716714,2717754,alcohol dehydrogenase,1040
SARO_RS12655,Saro_2513,2717729,2718886,aminotransferase,1157
SARO_RS12660,Saro_2514,2718951,2719328,ModE family transcriptional regulator,377
SARO_RS12665,Saro_2515,2719619,2720899,amidohydrolase family protein,1280
SARO_RS12670,Saro_2516,2720987,2721454,hypothetical protein,467
SARO_RS12675,NA,2721511,2721759,hypothetical protein,248
SARO_RS12680,Saro_2518,2721893,2722678,NUDIX domain-containing protein,785
SARO_RS12685,Saro_2519,2722991,2723320,monothiol glutaredoxin%2C Grx4 family,329
SARO_RS12690,Saro_2520,2723345,2723578,BolA family transcriptional regulator,233
SARO_RS12695,Saro_2521,2723578,2723901,DUF1476 domain-containing protein,323
SARO_RS12700,NA,2724014,2724580,hypothetical protein,566
SARO_RS12705,Saro_2523,2724740,2725330,hypothetical protein,590
SARO_RS12710,Saro_2524,2725475,2727619,S9 family peptidase,2144
SARO_RS12715,Saro_2525,2727747,2729882,S9 family peptidase,2135
SARO_RS12720,Saro_2526,2730199,2730624,50S ribosomal protein L17,425
SARO_RS12725,Saro_2527,2730746,2731807,DNA-directed RNA polymerase subunit alpha,1061
SARO_RS12730,Saro_2528,2731923,2732312,30S ribosomal protein S11,389
SARO_RS12735,Saro_2529,2732361,2732729,30S ribosomal protein S13,368
SARO_RS12740,Saro_2530,2733048,2733509,hypothetical protein,461
SARO_RS12745,NA,2733656,2734054,acyltransferase,398
SARO_RS12750,Saro_2532,2734123,2734542,hypothetical protein,419
SARO_RS12755,Saro_2533,2734524,2736611,bifunctional (p)ppGpp synthetase/guanosine-3'%2C5'-bis(diphosphate) 3'-pyrophosphohydrolase,2087
SARO_RS12760,Saro_2534,2736748,2737959,DUF2029 domain-containing protein,1211
SARO_RS12765,Saro_2535,2737946,2738572,N-acetyltransferase,626
SARO_RS12770,Saro_2536,2738577,2739440,oxygen-dependent coproporphyrinogen oxidase,863
SARO_RS12775,Saro_2537,2739485,2740159,phosphoesterase,674
SARO_RS12780,Saro_2538,2740284,2740805,translation initiation factor IF-3,521
SARO_RS12785,Saro_2539,2741051,2741350,hypothetical protein,299
SARO_RS12790,NA,2741432,2742238,hypothetical protein,806
SARO_RS12795,Saro_2541,2742309,2744999,TonB-dependent receptor,2690
SARO_RS12800,NA,2745095,2745412,hypothetical protein,317
SARO_RS12805,Saro_2542,2745445,2747283,translational GTPase TypA,1838
SARO_RS12810,NA,2747347,2747997,hemerythrin domain-containing protein,650
SARO_RS12815,Saro_2544,2748173,2749378,glycosyltransferase family 1 protein,1205
SARO_RS12820,Saro_2545,2749375,2749923,hypothetical protein,548
SARO_RS12825,Saro_2546,2749923,2750567,PadR family transcriptional regulator,644
SARO_RS12830,Saro_2547,2750666,2751988,replication-associated recombination protein A,1322
SARO_RS12835,Saro_2548,2751985,2752857,hypothetical protein,872
SARO_RS12845,NA,2753088,2753273,hypothetical protein,185
SARO_RS12850,NA,2753490,2753918,hypothetical protein,428
SARO_RS12855,Saro_2551,2753941,2754393,NADPH-dependent 7-cyano-7-deazaguanine reductase QueF,452
SARO_RS12860,NA,2754422,2755291,hypothetical protein,869
SARO_RS12865,NA,2755311,2755766,hypothetical protein,455
SARO_RS12870,Saro_2553,2755899,2756741,3-mercaptopyruvate sulfurtransferase,842
SARO_RS12875,Saro_2554,2756814,2758046,cystathionine beta-lyase,1232
SARO_RS12880,Saro_2555,2758043,2759008,mechanosensitive ion channel protein MscS,965
SARO_RS12885,Saro_2556,2759238,2760008,uroporphyrinogen-III C-methyltransferase,770
SARO_RS12890,Saro_2557,2760005,2760301,DUF2849 domain-containing protein,296
SARO_RS12895,Saro_2558,2760303,2761937,nitrite/sulfite reductase,1634
SARO_RS12900,Saro_2559,2761930,2762361,DUF934 domain-containing protein,431
SARO_RS12905,Saro_2560,2762385,2763197,phosphoadenylyl-sulfate reductase,812
SARO_RS12910,Saro_2561,2763327,2764727,C4-dicarboxylate ABC transporter,1400
SARO_RS12915,Saro_2562,2764917,2765588,hypothetical protein,671
SARO_RS12920,Saro_2563,2765588,2766340,hypothetical protein,752
SARO_RS12930,Saro_2565,2767495,2768811,hypothetical protein,1316
SARO_RS12935,Saro_2566,2768850,2769950,TrkA-N,1100
SARO_RS12940,Saro_2567,2770011,2772794,phosphoenolpyruvate carboxylase,2783
SARO_RS12945,Saro_2568,2772819,2773433,ketohydroxyglutarate aldolase,614
SARO_RS12950,Saro_2569,2773551,2774882,oxygen-independent coproporphyrinogen III oxidase,1331
SARO_RS12955,Saro_2570,2774890,2775138,hypothetical protein,248
SARO_RS12960,Saro_2571,2775135,2775284,cbb3-type cytochrome oxidase assembly protein CcoS,149
SARO_RS12965,Saro_2572,2775281,2777404,cadmium-translocating P-type ATPase,2123
SARO_RS12970,Saro_2573,2777401,2777871,integral membrane protein linked to a cation pump-like,470
SARO_RS12975,Saro_2574,2777868,2779337,cytochrome c oxidase accessory protein CcoG,1469
SARO_RS12980,Saro_2575,2779359,2780282,cytochrome-c oxidase%2C cbb3-type subunit III,923
SARO_RS12985,Saro_2576,2780275,2780445,CcoQ/FixQ family Cbb3-type cytochrome c oxidase assembly chaperone,170
SARO_RS12990,Saro_2577,2780442,2781191,cytochrome-c oxidase%2C cbb3-type subunit II,749
SARO_RS12995,Saro_2578,2781217,2782863,cytochrome-c oxidase%2C cbb3-type subunit I,1646
SARO_RS13000,Saro_2579,2783100,2783786,membrane protein,686
SARO_RS13005,Saro_2580,2784084,2786504,TonB-dependent receptor,2420
SARO_RS13010,Saro_2581,2786581,2787276,Crp/Fnr family transcriptional regulator,695
SARO_RS13015,Saro_2582,2787539,2788027,flavin reductase,488
SARO_RS13020,Saro_2583,2788082,2788993,hypothetical protein,911
SARO_RS13025,Saro_2584,2789273,2791003,ATP-dependent helicase,1730
SARO_RS13030,Saro_2585,2791267,2791524,translation initiation factor IF-1,257
SARO_RS13035,Saro_2586,2791529,2791735,cold-shock protein,206
SARO_RS13040,Saro_2587,2791974,2793791,elongation factor 4,1817
SARO_RS13045,Saro_2588,2794230,2795537,porin,1307
SARO_RS13050,Saro_2589,2795589,2796617,hypothetical protein,1028
SARO_RS13055,Saro_2590,2796840,2797214,glycine zipper 2TM domain-containing protein,374
SARO_RS13060,Saro_2591,2797271,2799415,S46 family peptidase,2144
SARO_RS13065,Saro_2592,2799463,2800737,class I SAM-dependent methyltransferase,1274
SARO_RS13070,Saro_2593,2800825,2802342,methylmalonyl-CoA carboxyltransferase,1517
SARO_RS13075,Saro_2594,2802353,2803405,DNA topoisomerase,1052
SARO_RS13080,Saro_2595,2803495,2804361,glutathione-dependent disulfide-bond oxidoreductase,866
SARO_RS13090,Saro_2596,2804853,2805413,hypothetical protein,560
SARO_RS13095,Saro_2597,2805478,2806278,acetoacetate decarboxylase,800
SARO_RS13100,Saro_2598,2806423,2807313,5-carboxymethyl-2-hydroxymuconate isomerase,890
SARO_RS13105,Saro_2599,2807327,2808745,aldehyde dehydrogenase family protein,1418
SARO_RS20695,NA,2809501,2809866,AraC family transcriptional regulator,365
SARO_RS13115,Saro_2601,2809891,2812260,ligand-gated channel,2369
SARO_RS13120,Saro_2602,2812382,2813683,4-aminobutyrate--2-oxoglutarate transaminase,1301
SARO_RS13125,Saro_2603,2813680,2815092,NAD-dependent succinate-semialdehyde dehydrogenase,1412
SARO_RS13130,Saro_2604,2815108,2816343,MFS transporter,1235
SARO_RS13135,Saro_2605,2816556,2817617,AraC family transcriptional regulator,1061
SARO_RS13140,Saro_2606,2817653,2818495,type 1 glutamine amidotransferase,842
SARO_RS13145,Saro_2607,2818565,2819437,catecholic dioxygenase,872
SARO_RS13150,Saro_2608,2819584,2820849,cytochrome P450,1265
SARO_RS13155,Saro_2609,2820902,2822227,glutamine synthetase,1325
SARO_RS13160,Saro_2610,2822235,2823695,betaine-aldehyde dehydrogenase,1460
SARO_RS13165,Saro_2611,2823727,2824686,AraC family transcriptional regulator,959
SARO_RS13170,Saro_2612,2824855,2827278,TonB-dependent receptor,2423
SARO_RS13175,Saro_2613,2827306,2828118,alpha/beta hydrolase,812
SARO_RS13180,Saro_2614,2828193,2828594,globin,401
SARO_RS13185,Saro_2615,2828659,2829504,hypothetical protein,845
SARO_RS13190,Saro_2616,2829738,2831276,SulP family inorganic anion transporter,1538
SARO_RS13195,Saro_2617,2831273,2831965,carbonic anhydrase,692
SARO_RS13200,Saro_2618,2832091,2833401,ATP-binding protein,1310
SARO_RS13205,Saro_2619,2833398,2834120,DNA-binding response regulator,722
SARO_RS13210,NA,2834191,2834763,hypothetical protein,572
SARO_RS13215,NA,2834823,2835098,hypothetical protein,275
SARO_RS13220,Saro_2621,2835202,2835537,DOPA 4%2C5-dioxygenase,335
SARO_RS13225,Saro_2622,2835569,2837452,propionyl-CoA synthetase,1883
SARO_RS13230,Saro_2623,2837522,2839213,MFS transporter,1691
SARO_RS13235,Saro_2624,2839239,2840651,hypothetical protein,1412
SARO_RS13240,Saro_2625,2840827,2842776,acetyl-coenzyme A synthetase,1949
SARO_RS13245,Saro_2626,2842798,2843421,DNA-binding response regulator,623
SARO_RS13250,Saro_2627,2843398,2846748,histidine kinase,3350
SARO_RS13345,Saro_2628,2864412,2865608,glycosyltransferase family 2 protein,1196
SARO_RS13350,Saro_2629,2865650,2867119,hypothetical protein,1469
SARO_RS13355,Saro_2630,2867173,2868108,peptidase A2,935
SARO_RS13360,Saro_2631,2868163,2869989,ATM1-type heavy metal exporter,1826
SARO_RS13365,Saro_2632,2870055,2870255,DUF1737 domain-containing protein,200
SARO_RS13370,Saro_2633,2870264,2870740,N-acetyltransferase,476
SARO_RS13375,Saro_2634,2870737,2872038,ATP-dependent protease ATPase subunit HslU,1301
SARO_RS13380,Saro_2635,2872135,2872692,ATP-dependent protease subunit HslV,557
SARO_RS13385,Saro_2636,2872738,2873232,outer membrane protein assembly factor BamE,494
SARO_RS13390,Saro_2637,2873435,2873953,hypothetical protein,518
SARO_RS13395,Saro_2638,2873950,2874465,DUF177 domain-containing protein,515
SARO_RS13400,Saro_2639,2874527,2875915,MATE family efflux transporter,1388
SARO_RS13405,Saro_2640,2875964,2877673,DUF87 domain-containing protein,1709
SARO_RS13410,Saro_2641,2877773,2878495,hypothetical protein,722
SARO_RS13415,Saro_2642,2878522,2879436,sulfite exporter TauE/SafE family protein,914
SARO_RS20270,Saro_2643,2879513,2880616,hypothetical protein,1103
SARO_RS13425,Saro_2644,2880616,2882082,hypothetical protein,1466
SARO_RS13430,Saro_2645,2882210,2883382,Na+/H+ antiporter NhaA 2,1172
SARO_RS13435,Saro_2646,2883484,2883939,DNA starvation/stationary phase protection protein,455
SARO_RS13440,Saro_2647,2883943,2884677,type II secretion system protein N,734
SARO_RS13445,Saro_2648,2884674,2885153,hypothetical protein,479
SARO_RS13450,Saro_2649,2885150,2886268,general secretion pathway protein GspL,1118
SARO_RS13455,Saro_2650,2886278,2886745,type II secretion system protein GspG,467
SARO_RS13460,Saro_2651,2886748,2887977,type II secretion system protein GspF,1229
SARO_RS13465,Saro_2652,2887977,2889467,type II secretion system protein GspE,1490
SARO_RS13470,Saro_2653,2889499,2891745,type II secretion system protein GspD,2246
SARO_RS13475,Saro_2654,2891742,2892545,PDZ domain-containing protein,803
SARO_RS13480,Saro_2655,2892766,2893251,NUDIX domain-containing protein,485
SARO_RS13485,Saro_2656,2893230,2894366,DNA polymerase IV,1136
SARO_RS13490,Saro_2657,2894441,2895709,Bcr/CflA family drug resistance efflux transporter,1268
SARO_RS13495,Saro_2658,2895710,2897707,GGDEF-domain containing protein,1997
SARO_RS13500,Saro_2659,2897751,2898548,LysR family transcriptional regulator,797
SARO_RS13505,Saro_2660,2898561,2898959,Co2+/Mg2+ efflux protein ApaG,398
SARO_RS13510,Saro_2661,2899056,2899664,DNA recombination protein RecF,608
SARO_RS13515,Saro_2662,2899712,2900770,3-isopropylmalate dehydrogenase,1058
SARO_RS13520,Saro_2663,2900783,2901904,glycosyltransferase family 2 protein,1121
SARO_RS13525,Saro_2664,2901927,2903246,phospholipid carrier-dependent glycosyltransferase,1319
SARO_RS13530,Saro_2665,2903330,2904538,aminotransferase class V-fold PLP-dependent enzyme,1208
SARO_RS13535,Saro_2666,2904622,2905962,PAS domain S-box protein,1340
SARO_RS13540,Saro_2667,2905959,2906210,hypothetical protein,251
SARO_RS13545,Saro_2668,2906274,2906828,tryptophan-rich sensory protein,554
SARO_RS13550,Saro_2669,2906949,2907731,TlyA family rRNA (cytidine-2'-O)-methyltransferase,782
SARO_RS13555,Saro_2670,2907730,2908287,hypothetical protein,557
SARO_RS13560,Saro_2671,2908711,2909814,branched-chain amino acid aminotransferase,1103
SARO_RS13565,Saro_2672,2909887,2911326,phosphate porin,1439
SARO_RS13570,Saro_2673,2911534,2912442,KR domain-containing protein,908
SARO_RS13575,Saro_2674,2912612,2913397,siroheme synthase,785
SARO_RS13580,Saro_2675,2913402,2914661,diaminopimelate decarboxylase,1259
SARO_RS13585,Saro_2676,2914673,2914924,hypothetical protein,251
SARO_RS13590,Saro_2677,2914921,2916303,argininosuccinate lyase,1382
SARO_RS13595,Saro_2678,2916374,2916925,TlpA family protein disulfide reductase,551
SARO_RS13600,Saro_2679,2917053,2918192,phosphoserine transaminase,1139
SARO_RS13605,Saro_2680,2918381,2919967,phosphoglycerate dehydrogenase,1586
SARO_RS13610,Saro_2681,2920156,2921307,ATP phosphoribosyltransferase regulatory subunit,1151
SARO_RS13615,Saro_2682,2921348,2922322,alpha/beta hydrolase,974
SARO_RS13620,Saro_2683,2922561,2923850,adenylosuccinate synthetase,1289
SARO_RS13625,Saro_2684,2923921,2924424,hypothetical protein,503
SARO_RS13630,Saro_2685,2924512,2925492,hypothetical protein,980
SARO_RS13635,Saro_2686,2925551,2926183,FABP family protein,632
SARO_RS13640,Saro_2687,2926498,2927220,DUF861 domain-containing protein,722
SARO_RS20275,Saro_2688,2927202,2927837,SCO family protein,635
SARO_RS13650,Saro_2689,2927888,2929483,hypothetical protein,1595
SARO_RS13655,Saro_2690,2929417,2930913,hypothetical protein,1496
SARO_RS13660,Saro_2691,2931041,2932786,sodium/hydrogen exchanger,1745
SARO_RS13670,Saro_2692,2932972,2934186,integrase,1214
SARO_RS13675,NA,2934481,2934726,hypothetical protein,245
SARO_RS13680,Saro_2694,2934783,2935445,hypothetical protein,662
SARO_RS13685,Saro_2695,2935442,2935678,hypothetical protein,236
SARO_RS13695,Saro_2697,2936062,2936298,DUF2312 domain-containing protein,236
SARO_RS13700,Saro_2698,2936298,2936492,hypothetical protein,194
SARO_RS13705,Saro_2699,2936495,2937379,rect protein,884
SARO_RS13710,Saro_2700,2937379,2938290,endonuclease,911
SARO_RS13715,Saro_2702,2938885,2939229,hypothetical protein,344
SARO_RS13720,NA,2939334,2939726,hypothetical protein,392
SARO_RS13725,Saro_2703,2939733,2940137,hypothetical protein,404
SARO_RS13730,Saro_2704,2940137,2940820,helix-turn-helix transcriptional regulator,683
SARO_RS13735,NA,2940943,2941398,hypothetical protein,455
SARO_RS20280,Saro_2705,2941416,2941907,hypothetical protein,491
SARO_RS13745,Saro_2706,2941934,2942581,hypothetical protein,647
SARO_RS13750,Saro_2707,2942581,2942874,hypothetical protein,293
SARO_RS13755,NA,2943230,2943460,hypothetical protein,230
SARO_RS13760,Saro_2709,2943638,2943826,hypothetical protein,188
SARO_RS13765,Saro_2710,2943823,2944263,hypothetical protein,440
SARO_RS13770,NA,2944260,2944448,hypothetical protein,188
SARO_RS13775,Saro_2711,2944445,2945338,hypothetical protein,893
SARO_RS13780,Saro_2712,2945335,2946594,hypothetical protein,1259
SARO_RS13785,Saro_2713,2946869,2947111,hypothetical protein,242
SARO_RS13790,Saro_2714,2947108,2947431,hypothetical protein,323
SARO_RS13795,Saro_2715,2947428,2947976,terminase small subunit,548
SARO_RS13800,Saro_2716,2947963,2949339,phage protein,1376
SARO_RS20700,Saro_2717,2949340,2949612,hypothetical protein,272
SARO_RS13805,NA,2949732,2951636,DUF1073 domain-containing protein,1904
SARO_RS13815,Saro_2720,2952123,2952923,hypothetical protein,800
SARO_RS20285,NA,2952920,2953186,hypothetical protein,266
SARO_RS13825,Saro_2722,2953470,2954543,DUF2213 domain-containing protein,1073
SARO_RS13830,Saro_2723,2954556,2955023,hypothetical protein,467
SARO_RS13835,Saro_2724,2955037,2956128,DUF2184 domain-containing protein,1091
SARO_RS13840,Saro_2726,2956413,2956787,DUF4054 domain-containing protein,374
SARO_RS13845,NA,2956760,2957158,hypothetical protein,398
SARO_RS13850,Saro_2728,2957086,2957568,hypothetical protein,482
SARO_RS20290,Saro_2729,2957689,2958120,DUF3168 domain-containing protein,431
SARO_RS13860,Saro_2730,2958141,2958371,hypothetical protein,230
SARO_RS13865,NA,2958379,2958894,helix-turn-helix domain-containing protein,515
SARO_RS13870,Saro_2732,2958876,2959208,DUF4258 domain-containing protein,332
SARO_RS13875,Saro_2733,2959365,2959814,hypothetical protein,449
SARO_RS13880,Saro_2734,2959818,2960222,hypothetical protein,404
SARO_RS13885,Saro_2735,2960429,2960695,hypothetical protein,266
SARO_RS13890,Saro_2736,2960755,2963025,hypothetical protein,2270
SARO_RS13895,Saro_2737,2963025,2963579,hypothetical protein,554
SARO_RS13900,Saro_2738,2963579,2963962,hypothetical protein,383
SARO_RS13905,Saro_2739,2963955,2965928,hypothetical protein,1973
SARO_RS13915,NA,2965925,2967073,hypothetical protein,1148
SARO_RS20295,Saro_2741,2967164,2967811,hypothetical protein,647
SARO_RS13925,Saro_2742,2967808,2968197,hypothetical protein,389
SARO_RS13930,Saro_2743,2968197,2968664,hypothetical protein,467
SARO_RS13935,Saro_2744,2968661,2970802,hypothetical protein,2141
SARO_RS13940,Saro_2745,2970802,2971140,hypothetical protein,338
SARO_RS13945,Saro_2746,2971137,2971727,glycoside hydrolase,590
SARO_RS13950,Saro_2747,2971828,2972094,hypothetical protein,266
SARO_RS13955,Saro_2748,2972091,2972390,hypothetical protein,299
SARO_RS13960,Saro_2749,2972601,2972819,hypothetical protein,218
SARO_RS13965,NA,2973213,2973401,hypothetical protein,188
SARO_RS13970,Saro_2750,2973398,2974189,FkbM family methyltransferase,791
SARO_RS13975,Saro_2752,2974626,2975435,hypothetical protein,809
SARO_RS13980,NA,2976961,2977167,hypothetical protein,206
SARO_RS13985,Saro_2755,2977208,2977510,hypothetical protein,302
SARO_RS13990,NA,2977809,2978477,hypothetical protein,668
SARO_RS20705,NA,2979464,2980221,IS5/IS1182 family transposase,757
SARO_RS20705,NA,2979464,2980221,IS5/IS1182 family transposase,757
SARO_RS14010,Saro_2761,2980950,2981309,hypothetical protein,359
SARO_RS14015,Saro_2762,2981469,2982089,glutathione S-transferase family protein,620
SARO_RS14020,Saro_2763,2982157,2984184,FAD-binding oxidoreductase,2027
SARO_RS14025,Saro_2764,2984217,2984681,DUF1348 domain-containing protein,464
SARO_RS14030,Saro_2765,2984834,2985742,LysR family transcriptional regulator,908
SARO_RS14035,Saro_2766,2985817,2986299,nuclear transport factor 2 family protein,482
SARO_RS14040,Saro_2767,2986394,2987377,KR domain-containing protein,983
SARO_RS14045,Saro_2768,2987418,2988449,alcohol dehydrogenase,1031
SARO_RS14050,Saro_2769,2988513,2989418,LysR family transcriptional regulator,905
SARO_RS14055,Saro_2770,2989657,2990319,extensin,662
SARO_RS14060,Saro_2771,2990334,2990954,LuxR family transcriptional regulator,620
SARO_RS14065,Saro_2772,2991231,2991995,peptidase,764
SARO_RS14070,Saro_2773,2992078,2992890,transglutaminase family protein,812
SARO_RS14075,Saro_2774,2992899,2993846,alpha-E domain-containing protein,947
SARO_RS14080,Saro_2775,2993846,2995279,circularly permuted type 2 ATP-grasp protein,1433
SARO_RS14085,Saro_2776,2995464,2997527,molybdopterin dinucleotide-binding region,2063
SARO_RS14090,Saro_2777,2997589,2998008,globin,419
SARO_RS14095,Saro_2778,2998012,2998821,alpha/beta hydrolase,809
SARO_RS14100,Saro_2779,2998916,2999470,DUF3617 domain-containing protein,554
SARO_RS14105,Saro_2780,2999575,3001764,excinuclease ABC subunit UvrB,2189
SARO_RS14110,NA,3001869,3002333,hypothetical protein,464
SARO_RS14115,Saro_2782,3002334,3002915,hypothetical protein,581
SARO_RS14120,Saro_2783,3002951,3004435,polysaccharide biosynthesis protein,1484
SARO_RS14125,Saro_2784,3004428,3005423,glycerol-3-phosphate dehydrogenase (NAD(P)(+)),995
SARO_RS14130,Saro_2785,3005420,3006472,tRNA (adenosine(37)-N6)-threonylcarbamoyltransferase complex transferase subunit TsaD,1052
SARO_RS14135,Saro_2786,3006518,3007456,hydroxymethylbilane synthase,938
SARO_RS14140,Saro_2787,3007453,3008133,uroporphyrinogen-III synthase,680
SARO_RS14145,Saro_2788,3008163,3009053,hypothetical protein,890
SARO_RS14150,Saro_2789,3009076,3010296,ubiquinone biosynthesis protein UbiH,1220
SARO_RS14155,Saro_2790,3010293,3011990,alkaline phosphatase family protein,1697
SARO_RS14160,Saro_2791,3012112,3014172,thiol:disulfide interchange protein,2060
SARO_RS14165,Saro_2792,3014182,3014955,KR domain-containing protein,773
SARO_RS14170,Saro_2793,3015091,3017376,DNA topoisomerase IV subunit A,2285
SARO_RS14175,Saro_2794,3017505,3018956,hypothetical protein,1451
SARO_RS14180,Saro_2795,3019067,3020224,alcohol dehydrogenase,1157
SARO_RS14185,Saro_2796,3020291,3020623,(2Fe-2S) ferredoxin,332
SARO_RS14190,Saro_2797,3020625,3021707,cysteine desulfurase,1082
SARO_RS14195,Saro_2798,3021704,3022750,aminotransferase class V-fold PLP-dependent enzyme,1046
SARO_RS14200,Saro_2799,3022879,3023535,alpha/beta hydrolase,656
SARO_RS14205,Saro_2800,3023603,3024439,KR domain-containing protein,836
SARO_RS14210,Saro_2801,3024456,3025925,aldehyde dehydrogenase,1469
SARO_RS14215,Saro_2802,3025940,3026341,hypothetical protein,401
SARO_RS14220,Saro_2803,3026531,3028921,TonB-dependent receptor,2390
SARO_RS20300,Saro_2804,3029036,3029587,MarR family transcriptional regulator,551
SARO_RS14230,Saro_2805,3029605,3030336,nuclear transport factor 2 family protein,731
SARO_RS14235,Saro_2806,3030486,3031349,dienelactone hydrolase family protein,863
SARO_RS14240,Saro_2807,3031475,3031801,excinuclease ABC subunit C,326
SARO_RS14245,Saro_2808,3032114,3033031,NAD(P)-dependent oxidoreductase,917
SARO_RS14250,Saro_2809,3033028,3034521,carotenoid oxygenase,1493
SARO_RS14255,Saro_2810,3034579,3035367,hypothetical protein,788
SARO_RS14260,Saro_2811,3035500,3036444,gfo/Idh/MocA family oxidoreductase,944
SARO_RS14265,Saro_2812,3036468,3037310,protocatechuate 3%2C4-dioxygenase subunit beta,842
SARO_RS14270,Saro_2813,3037312,3037749,protocatechuate 4%2C5-dioxygenase subunit alpha,437
SARO_RS14275,Saro_2814,3037746,3038771,amidohydrolase,1025
SARO_RS14280,Saro_2815,3038768,3039601,NAD(P)-dependent oxidoreductase,833
SARO_RS14285,Saro_2816,3039664,3040815,LysR family transcriptional regulator,1151
SARO_RS14290,Saro_2817,3040922,3041596,4-carboxy-4-hydroxy-2-oxoadipate aldolase/oxaloacetate decarboxylase,674
SARO_RS14295,Saro_2818,3041744,3042802,4-oxalomesaconate tautomerase,1058
SARO_RS14300,Saro_2819,3042799,3043689,2-pyrone-4%2C6-dicarboxylate hydrolase,890
SARO_RS14305,Saro_2820,3043716,3044132,hypothetical protein,416
SARO_RS14310,Saro_2821,3044321,3046384,methyl-accepting chemotaxis protein,2063
SARO_RS14315,Saro_2822,3046435,3046779,energy transducer TonB,344
SARO_RS14320,Saro_2823,3046851,3048119,amidohydrolase family protein,1268
SARO_RS14325,Saro_2824,3048765,3051344,ATP-dependent chaperone ClpB,2579
SARO_RS14330,Saro_2825,3051535,3053154,peptidase M28,1619
SARO_RS14335,Saro_2826,3053366,3056224,insulinase family protein,2858
SARO_RS14340,Saro_2827,3056332,3056628,hypothetical protein,296
SARO_RS14345,Saro_2828,3056672,3057211,hypothetical protein,539
SARO_RS14350,Saro_2829,3057306,3057845,hypothetical protein,539
SARO_RS14355,Saro_2830,3057855,3058298,hypothetical protein,443
SARO_RS14360,Saro_2831,3058378,3059871,Asp-tRNA(Asn)/Glu-tRNA(Gln) amidotransferase GatCAB subunit B,1493
SARO_RS14365,Saro_2832,3059873,3061357,Asp-tRNA(Asn)/Glu-tRNA(Gln) amidotransferase GatCAB subunit A,1484
SARO_RS14370,Saro_2833,3061357,3061659,Asp-tRNA(Asn)/Glu-tRNA(Gln) amidotransferase GatCAB subunit C,302
SARO_RS14375,Saro_2834,3061771,3062334,peptidylprolyl isomerase,563
SARO_RS14380,Saro_2835,3062508,3062714,30S ribosomal protein S21,206
SARO_RS14385,Saro_2836,3062901,3063299,fluoride efflux transporter CrcB,398
SARO_RS14390,Saro_2837,3063311,3064606,RluA family pseudouridine synthase,1295
SARO_RS14395,Saro_2838,3064606,3065208,FMN-binding negative transcriptional regulator,602
SARO_RS14400,Saro_2839,3065219,3065875,haloacid dehalogenase,656
SARO_RS14405,NA,3065872,3066138,hypothetical protein,266
SARO_RS14410,Saro_2841,3066140,3066832,molecular chaperone,692
SARO_RS14415,Saro_2842,3066845,3067417,ABC transporter,572
SARO_RS14420,Saro_2843,3067432,3068391,MCE family protein,959
SARO_RS14425,Saro_2844,3068402,3069304,ABC transporter ATP-binding protein,902
SARO_RS14430,Saro_2845,3069304,3070422,ABC transporter permease,1118
SARO_RS14435,Saro_2846,3070572,3073286,valine--tRNA ligase,2714
SARO_RS14440,Saro_2847,3073305,3074048,7-carboxy-7-deazaguanine synthase QueE,743
SARO_RS14445,Saro_2848,3074150,3074701,single-stranded DNA-binding protein,551
SARO_RS14450,Saro_2849,3074799,3076655,ferrous iron transporter B,1856
SARO_RS14455,Saro_2850,3076652,3076909,ferrous iron transport protein A,257
SARO_RS14460,Saro_2851,3076998,3077651,COQ9 family protein,653
SARO_RS14465,Saro_2852,3077665,3078258,ankyrin repeat domain-containing protein,593
SARO_RS14470,Saro_2853,3078375,3078989,SCO family protein,614
SARO_RS14475,Saro_2854,3078997,3079470,YcgN family cysteine cluster protein,473
SARO_RS14480,Saro_2855,3079463,3080221,M48 family peptidase,758
SARO_RS14485,Saro_2856,3080262,3080753,hypothetical protein,491
SARO_RS14490,Saro_2857,3080750,3081721,bifunctional diaminohydroxyphosphoribosylaminopyrimidine deaminase/5-amino-6-(5-phosphoribosylamino)uracil reductase RibD,971
SARO_RS14495,Saro_2858,3081734,3082357,riboflavin synthase,623
SARO_RS14500,Saro_2859,3082415,3083128,alpha/beta hydrolase,713
SARO_RS14505,Saro_2860,3083086,3083970,methylenetetrahydrofolate reductase,884
SARO_RS14510,Saro_2861,3084044,3085444,aminomethyl transferase family protein,1400
SARO_RS14515,Saro_2862,3085570,3086424,formyltetrahydrofolate deformylase,854
SARO_RS14520,Saro_2863,3086505,3086906,glyoxalase/bleomycin resistance protein/dioxygenase,401
SARO_RS14525,NA,3087013,3087750,alpha/beta hydrolase,737
SARO_RS14530,Saro_2865,3087750,3088562,glutathione S-transferase family protein,812
SARO_RS14535,Saro_2866,3088531,3089280,NAD(P)-dependent oxidoreductase,749
SARO_RS14540,Saro_2867,3089277,3089738,hypothetical protein,461
SARO_RS14545,Saro_2868,3089774,3090646,4-hydroxyphenyl-beta-ketoacyl-CoA hydrolase,872
SARO_RS14550,Saro_2869,3090707,3092221,aldehyde dehydrogenase,1514
SARO_RS14555,Saro_2870,3092342,3094459,PQQ-dependent dehydrogenase%2C methanol/ethanol family,2117
SARO_RS14560,Saro_2871,3094493,3096058,AMP-dependent synthetase,1565
SARO_RS14565,Saro_2872,3096062,3096847,glutathione S-transferase family protein,785
SARO_RS14570,Saro_2873,3096844,3097614,glutathione S-transferase family protein,770
SARO_RS14575,Saro_2874,3097877,3098245,hypothetical protein,368
SARO_RS14580,Saro_2875,3098245,3098649,cytochrome c,404
SARO_RS14585,Saro_2876,3098651,3100237,FAD-binding oxidoreductase,1586
SARO_RS14590,Saro_2877,3100344,3100841,DUF3237 domain-containing protein,497
SARO_RS14595,Saro_2878,3100898,3103078,PQQ-dependent dehydrogenase%2C methanol/ethanol family,2180
SARO_RS14600,Saro_2879,3103078,3103935,hypothetical protein,857
SARO_RS14605,Saro_2880,3104026,3104415,hypothetical protein,389
SARO_RS14610,Saro_2881,3104375,3104881,hypothetical protein,506
SARO_RS14615,Saro_2882,3104889,3105629,KR domain-containing protein,740
SARO_RS14620,Saro_2883,3105644,3105853,hypothetical protein,209
SARO_RS14625,Saro_2884,3105921,3107255,class II glutamine amidotransferase,1334
SARO_RS20305,Saro_2885,3106835,3107800,cyclic nucleotide-binding protein domain-containing protein,965
SARO_RS14635,Saro_2886,3107867,3108307,ATPase,440
SARO_RS14640,Saro_2887,3108322,3109002,glutathione S-transferase family protein,680
SARO_RS14645,Saro_2888,3109004,3109501,VOC family protein,497
SARO_RS14650,Saro_2889,3109498,3110127,glutathione S-transferase family protein,629
SARO_RS14655,Saro_2890,3110200,3110847,glutathione S-transferase family protein,647
SARO_RS14660,Saro_2891,3110927,3111907,cobaltochelatase subunit CobS,980
SARO_RS14665,Saro_2892,3111968,3113083,NADH oxidase,1115
SARO_RS14670,Saro_2893,3113088,3113852,tRNA pseudouridine(38-40) synthase TruA,764
SARO_RS14675,Saro_2894,3113845,3114750,methionyl-tRNA formyltransferase,905
SARO_RS14680,Saro_2895,3114802,3115398,recombination protein RecR,596
SARO_RS14685,Saro_2896,3115464,3116030,peptide deformylase,566
SARO_RS14695,Saro_2898,3116607,3118121,DNA recombination protein RmuC,1514
SARO_RS14700,Saro_2899,3118118,3118897,hypothetical protein,779
SARO_RS14705,NA,3118903,3119304,META domain-containing protein,401
SARO_RS14710,Saro_2901,3119359,3120162,RNA methyltransferase,803
SARO_RS14715,Saro_2902,3120214,3120522,HPr family phosphocarrier protein,308
SARO_RS14720,Saro_2903,3120524,3120928,PTS fructose transporter subunit IIA,404
SARO_RS14725,Saro_2904,3121064,3121981,RNase adaptor protein RapZ,917
SARO_RS14730,Saro_2905,3122043,3122468,HPr kinase,425
SARO_RS14735,Saro_2906,3122465,3124042,HAMP domain-containing protein,1577
SARO_RS14740,Saro_2907,3124029,3124781,DNA-binding response regulator,752
SARO_RS14745,Saro_2908,3125015,3126619,phosphoenolpyruvate carboxykinase (ATP),1604
SARO_RS14750,Saro_2909,3126810,3129053,catalase-peroxidase,2243
SARO_RS14755,Saro_2910,3129100,3129690,molecular chaperone DnaJ,590
SARO_RS14760,Saro_2911,3129731,3130003,BolA family transcriptional regulator,272
SARO_RS14765,Saro_2912,3130142,3130591,NUDIX domain-containing protein,449
SARO_RS14770,Saro_2913,3130588,3131478,pirin family protein,890
SARO_RS14775,Saro_2914,3131492,3133114,xylan 1%2C4-beta-xylosidase,1622
SARO_RS14780,Saro_2915,3133388,3134218,23S rRNA (adenine(2030)-N(6))-methyltransferase RlmJ,830
SARO_RS14785,Saro_2916,3134479,3135297,KR domain-containing protein,818
SARO_RS14790,Saro_2917,3135294,3136181,alpha/beta hydrolase,887
SARO_RS14795,Saro_2918,3136178,3137239,DUF2332 domain-containing protein,1061
SARO_RS14800,Saro_2919,3137282,3137953,ATP phosphoribosyltransferase,671
SARO_RS14805,Saro_2920,3137953,3139242,histidinol dehydrogenase,1289
SARO_RS14810,Saro_2921,3139239,3139685,N utilization substance protein B,446
SARO_RS14815,Saro_2922,3139911,3140762,S-formylglutathione hydrolase,851
SARO_RS14820,Saro_2923,3140768,3141139,VOC family protein,371
SARO_RS14825,Saro_2924,3141239,3141898,hypothetical protein,659
SARO_RS14830,Saro_2925,3142113,3142490,copper resistance protein C,377
SARO_RS14835,Saro_2926,3142634,3142897,hypothetical protein,263
SARO_RS14840,Saro_2927,3142897,3143334,hypothetical protein,437
SARO_RS14845,Saro_2928,3143341,3143904,RNA polymerase sigma factor,563
SARO_RS14850,Saro_2929,3143931,3145715,copper resistance system multicopper oxidase,1784
SARO_RS14855,Saro_2930,3145712,3146755,copper resistance protein B,1043
SARO_RS14860,Saro_2931,3146835,3147533,copper resistance protein B,698
SARO_RS14865,Saro_2932,3147585,3148733,amidohydrolase,1148
SARO_RS14870,Saro_2933,3148778,3149275,Lrp/AsnC family transcriptional regulator,497
SARO_RS14875,Saro_2934,3149299,3150699,aspartate aminotransferase family protein,1400
SARO_RS14880,Saro_2935,3150843,3151922,tartrate dehydrogenase,1079
SARO_RS14885,Saro_2936,3151939,3153396,NAD-dependent succinate-semialdehyde dehydrogenase,1457
SARO_RS14890,Saro_2937,3153396,3154253,N-acetyltransferase,857
SARO_RS14895,Saro_2938,3154454,3155926,aldehyde dehydrogenase,1472
SARO_RS14900,Saro_2939,3155971,3157107,FAD-binding oxidoreductase,1136
SARO_RS14905,Saro_2940,3157104,3158483,FAD-binding protein,1379
SARO_RS14910,Saro_2941,3158480,3158788,NAD(FAD)-dependent dehydrogenase,308
SARO_RS14915,Saro_2942,3158785,3160533,ABC transporter,1748
SARO_RS14920,Saro_2943,3160530,3161354,ABC transporter permease,824
SARO_RS14925,Saro_2944,3161351,3162340,ABC transporter permease,989
SARO_RS14930,Saro_2945,3162340,3163869,ABC transporter substrate-binding protein,1529
SARO_RS14935,Saro_2946,3163869,3165152,FAD-binding oxidoreductase,1283
SARO_RS14940,Saro_2947,3165157,3165831,haloacid dehalogenase type II,674
SARO_RS14945,Saro_2948,3165997,3166926,glyoxylate/hydroxypyruvate reductase A,929
SARO_RS14950,Saro_2949,3166923,3167936,PepSY domain-containing protein,1013
SARO_RS14955,Saro_2950,3167995,3170157,TonB-dependent siderophore receptor,2162
SARO_RS14960,Saro_2951,3170469,3171677,DUF1624 domain-containing protein,1208
SARO_RS14965,Saro_2952,3171712,3172338,hypothetical protein,626
SARO_RS14970,Saro_2953,3172352,3173074,membrane protein,722
SARO_RS14975,Saro_2954,3173082,3173465,hypothetical protein,383
SARO_RS14980,Saro_2955,3173489,3174241,DUF4198 domain-containing protein,752
SARO_RS14985,Saro_2956,3174478,3174918,DUF2721 domain-containing protein,440
SARO_RS14990,Saro_2957,3174939,3175232,hypothetical protein,293
SARO_RS14995,Saro_2958,3175232,3175987,hypothetical protein,755
SARO_RS15000,Saro_2959,3175995,3177206,toxic anion resistance protein,1211
SARO_RS15005,Saro_2960,3177369,3178076,short-chain dehydrogenase,707
SARO_RS15010,Saro_2961,3178224,3178550,cytochrome c,326
SARO_RS15015,Saro_2962,3178547,3180175,FAD-binding oxidoreductase,1628
SARO_RS15020,Saro_2963,3180175,3180927,short chain dehydrogenase,752
SARO_RS15025,Saro_2964,3180940,3181818,MBL fold hydrolase,878
SARO_RS15030,Saro_2965,3181951,3182730,uroporphyrinogen-III C-methyltransferase,779
SARO_RS15035,Saro_2966,3182727,3185306,nitrate reductase,2579
SARO_RS15040,Saro_2967,3185309,3185650,nitrite reductase (NAD(P)H) small subunit,341
SARO_RS15045,Saro_2968,3185650,3188226,NAD(P)/FAD-dependent oxidoreductase,2576
SARO_RS15050,Saro_2969,3188360,3189616,hypothetical protein,1256
SARO_RS15055,Saro_2970,3189683,3190936,NarK/NasA family nitrate transporter,1253
SARO_RS15060,Saro_2971,3191032,3192723,bifunctional protein-serine/threonine kinase/phosphatase,1691
SARO_RS15065,Saro_2972,3192952,3194160,nitrate transporter,1208
SARO_RS15070,Saro_2973,3194160,3194738,ANTAR domain-containing protein,578
SARO_RS15075,Saro_2974,3194788,3195495,GMP synthase,707
SARO_RS15080,NA,3197039,3197218,hypothetical protein,179
SARO_RS15085,Saro_2977,3197427,3197930,hypothetical protein,503
SARO_RS15090,Saro_2978,3197923,3198303,hypothetical protein,380
SARO_RS15095,Saro_2980,3198592,3199014,hypothetical protein,422
SARO_RS15100,Saro_2981,3199004,3199204,hypothetical protein,200
SARO_RS15105,Saro_2982,3199201,3199644,hypothetical protein,443
SARO_RS15110,Saro_2983,3199882,3200304,hypothetical protein,422
SARO_RS15120,Saro_2984,3200915,3201277,hypothetical protein,362
SARO_RS15125,Saro_2985,3201523,3202038,hypothetical protein,515
SARO_RS20720,Saro_2986,3202079,3202432,DUF2493 domain-containing protein,353
SARO_RS15135,Saro_2987,3202684,3203901,hypothetical protein,1217
SARO_RS15140,NA,3203910,3204101,hypothetical protein,191
SARO_RS15145,Saro_2988,3204101,3206242,hypothetical protein,2141
SARO_RS15150,Saro_2989,3206239,3206682,hypothetical protein,443
SARO_RS20310,Saro_2990,3206684,3207823,hypothetical protein,1139
SARO_RS20315,Saro_2991,3207820,3208185,hypothetical protein,365
SARO_RS20320,Saro_2992,3208281,3208880,hypothetical protein,599
SARO_RS15170,Saro_2993,3208915,3211800,hypothetical protein,2885
SARO_RS15175,Saro_2994,3211802,3213004,hypothetical protein,1202
SARO_RS20325,Saro_2995,3213004,3213561,hypothetical protein,557
SARO_RS15185,Saro_2996,3213730,3214242,hypothetical protein,512
SARO_RS15190,Saro_2997,3214235,3215596,hypothetical protein,1361
SARO_RS15195,Saro_2998,3215596,3216036,hypothetical protein,440
SARO_RS15200,Saro_2999,3216036,3216863,hypothetical protein,827
SARO_RS15205,Saro_3000,3216865,3217158,hypothetical protein,293
SARO_RS15210,NA,3217158,3217343,hypothetical protein,185
SARO_RS15215,Saro_3001,3217437,3218699,hypothetical protein,1262
SARO_RS15220,Saro_3002,3218729,3219550,hypothetical protein,821
SARO_RS15225,Saro_3003,3219642,3221714,hypothetical protein,2072
SARO_RS15230,Saro_3004,3221762,3223216,hypothetical protein,1454
SARO_RS15235,Saro_3005,3223519,3223953,hypothetical protein,434
SARO_RS15240,NA,3223963,3224262,hypothetical protein,299
SARO_RS15245,NA,3224446,3224646,hypothetical protein,200
SARO_RS15250,NA,3224646,3225173,hypothetical protein,527
SARO_RS15255,Saro_3008,3225798,3226205,RusA family crossover junction endodeoxyribonuclease,407
SARO_RS15260,Saro_3009,3226202,3226663,hypothetical protein,461
SARO_RS20725,Saro_3010,3226660,3227346,hypothetical protein,686
SARO_RS15270,NA,3227492,3227710,hypothetical protein,218
SARO_RS15275,Saro_3011,3228155,3228640,hypothetical protein,485
SARO_RS15280,Saro_3012,3228726,3228929,zinc finger C4-type protein,203
SARO_RS15285,Saro_3014,3229409,3229675,transcriptional regulator,266
SARO_RS20735,NA,3230088,3230366,hypothetical protein,278
SARO_RS15300,Saro_3017,3230871,3231146,hypothetical protein,275
SARO_RS15305,Saro_3018,3231143,3231382,hypothetical protein,239
SARO_RS15310,NA,3231379,3231567,hypothetical protein,188
SARO_RS15315,Saro_3019,3231579,3231848,hypothetical protein,269
SARO_RS15320,NA,3232220,3232507,hypothetical protein,287
SARO_RS15325,NA,3232833,3233042,hypothetical protein,209
SARO_RS20335,Saro_3021,3233039,3233704,hypothetical protein,665
SARO_RS15335,Saro_3022,3233830,3234369,hypothetical protein,539
SARO_RS15340,Saro_3023,3234452,3234832,hypothetical protein,380
SARO_RS15350,NA,3235080,3235526,hypothetical protein,446
SARO_RS15355,NA,3235845,3237056,hypothetical protein,1211
SARO_RS15365,Saro_3027,3237240,3238598,DUF4010 domain-containing protein,1358
SARO_RS15370,Saro_3028,3238746,3240530,quinohemoprotein amine dehydrogenase subunit alpha,1784
SARO_RS15375,Saro_3029,3240527,3241981,quinohemoprotein amine dehydrogenase maturation protein,1454
SARO_RS15380,Saro_3030,3241978,3242304,hypothetical protein,326
SARO_RS15385,Saro_3031,3242442,3243542,hypothetical protein,1100
SARO_RS20740,NA,3243532,3243924,hypothetical protein,392
SARO_RS15395,Saro_3033,3244086,3246293,ABC transporter ATP-binding protein,2207
SARO_RS15400,Saro_3034,3246286,3246966,hypothetical protein,680
SARO_RS15405,Saro_3035,3247022,3249055,sulfotransferase family protein,2033
SARO_RS15410,Saro_3036,3249171,3251852,TonB-dependent receptor,2681
SARO_RS15415,Saro_3037,3252293,3252730,lactoylglutathione lyase,437
SARO_RS15420,Saro_3038,3252814,3253572,SIMPL domain-containing protein,758
SARO_RS15425,Saro_3039,3253707,3254489,hypothetical protein,782
SARO_RS15430,Saro_3040,3254703,3255509,serine/threonine protein phosphatase,806
SARO_RS15435,Saro_3042,3255880,3258405,TonB-dependent receptor,2525
SARO_RS15440,Saro_3043,3258473,3259195,monofunctional biosynthetic peptidoglycan transglycosylase,722
SARO_RS15445,Saro_3044,3259345,3260040,hypothetical protein,695
SARO_RS15450,Saro_3045,3260186,3261085,RNA polymerase sigma factor RpoH,899
SARO_RS15455,Saro_3046,3261197,3262174,RluA family pseudouridine synthase,977
SARO_RS15460,Saro_3047,3262218,3263393,carbohydrate porin,1175
SARO_RS15465,Saro_3048,3263390,3265195,methyl-accepting chemotaxis protein,1805
SARO_RS15470,Saro_3049,3265324,3265722,peptidase,398
SARO_RS15475,Saro_3050,3265879,3266520,histidine phosphotransferase,641
SARO_RS15480,Saro_3051,3266537,3267241,N-acetylmuramoyl-L-alanine amidase,704
SARO_RS15485,Saro_3052,3267702,3268658,cation transporter,956
SARO_RS15490,Saro_3053,3269011,3269586,fasciclin,575
SARO_RS15495,Saro_3054,3269818,3271074,ATP-dependent Clp protease ATP-binding subunit ClpX,1256
SARO_RS15500,Saro_3055,3271222,3271929,ATP-dependent Clp protease proteolytic subunit,707
SARO_RS15505,NA,3272069,3272734,PilZ domain-containing protein,665
SARO_RS15510,Saro_3057,3272946,3274487,amidase,1541
SARO_RS15515,NA,3274468,3274794,hypothetical protein,326
SARO_RS15520,NA,3274826,3275269,hypothetical protein,443
SARO_RS15525,Saro_3059,3275439,3276980,trigger factor,1541
SARO_RS15535,NA,3277393,3277575,hypothetical protein,182
SARO_RS15540,Saro_3060,3277719,3279596,signal peptide peptidase SppA,1877
SARO_RS15545,Saro_3061,3279684,3280709,aspartate carbamoyltransferase,1025
SARO_RS15550,Saro_3062,3280706,3281935,dihydroorotase,1229
SARO_RS15555,Saro_3063,3282003,3283325,SPOR domain-containing protein,1322
SARO_RS15560,Saro_3064,3283348,3283863,hypothetical protein,515
SARO_RS15565,Saro_3065,3283877,3284602,ParA family protein,725
SARO_RS15570,Saro_3066,3284809,3286107,Sel1 repeat-containing protein,1298
SARO_RS15575,Saro_3067,3286124,3287326,DUF418 domain-containing protein,1202
SARO_RS15580,Saro_3068,3287258,3288442,phosphatidylserine/phosphatidylglycerophosphate/cardiolipin synthase family protein,1184
SARO_RS15585,Saro_3069,3288488,3289687,glycosyltransferase,1199
SARO_RS15590,NA,3289801,3290493,L%2CD-transpeptidase,692
SARO_RS15595,Saro_3071,3290531,3291325,KR domain-containing protein,794
SARO_RS15600,Saro_3072,3291337,3292119,3-hydroxy-2-methylbutyryl-CoA dehydrogenase,782
SARO_RS15605,Saro_3073,3292116,3293096,nitronate monooxygenase,980
SARO_RS15610,Saro_3074,3293161,3293895,RNA polymerase subunit sigma,734
SARO_RS15615,Saro_3075,3294076,3296196,TonB-dependent receptor,2120
SARO_RS15620,Saro_3076,3296225,3296455,hypothetical protein,230
SARO_RS15625,Saro_3077,3296634,3296825,hypothetical protein,191
SARO_RS15630,Saro_3078,3296966,3297706,spermidine synthase,740
SARO_RS15635,Saro_3079,3297734,3298048,hypothetical protein,314
SARO_RS15640,Saro_3080,3298573,3299244,glutathione S-transferase family protein,671
SARO_RS15645,Saro_3081,3299458,3300423,complex I NDUFA9 subunit family protein,965
SARO_RS15655,Saro_3082,3301191,3302078,protein-tyrosine-phosphatase,887
SARO_RS20860,Saro_3083,3302081,3302860,NAD(P)-dependent oxidoreductase,779
SARO_RS15665,Saro_3084,3302873,3305065,TonB-dependent receptor,2192
SARO_RS15670,Saro_3085,3305260,3305907,TetR family transcriptional regulator,647
SARO_RS20340,Saro_3087,3306878,3308095,TauD/TfdA family dioxygenase,1217
SARO_RS15680,Saro_3088,3308092,3309804,D-aminoacylase,1712
SARO_RS15685,Saro_3089,3309817,3311082,helix-turn-helix transcriptional regulator,1265
SARO_RS15690,Saro_3090,3311225,3311611,RidA family protein,386
SARO_RS15695,NA,3312165,3312365,hypothetical protein,200
SARO_RS15705,Saro_3092,3312771,3313274,2-amino-4-hydroxy-6-hydroxymethyldihydropteridine diphosphokinase,503
SARO_RS15710,Saro_3093,3313271,3314119,N-carbamoylputrescine amidase,848
SARO_RS15715,Saro_3094,3314172,3315026,methyltransferase,854
SARO_RS15720,Saro_3095,3315106,3315642,peptide-methionine (S)-S-oxide reductase,536
SARO_RS15725,Saro_3096,3315639,3316898,methyltransferase domain-containing protein,1259
SARO_RS15730,Saro_3097,3316897,3317145,DUF1674 domain-containing protein,248
SARO_RS15735,Saro_3098,3317166,3317648,DUF4112 domain-containing protein,482
SARO_RS15740,Saro_3099,3317633,3319111,ABC transporter substrate-binding protein,1478
SARO_RS15745,Saro_3100,3319158,3319541,PilZ domain-containing protein,383
SARO_RS15750,Saro_3101,3319699,3320157,RNA polymerase-binding protein DksA,458
SARO_RS15755,Saro_3102,3320467,3320796,sel1 repeat family protein,329
SARO_RS15760,Saro_3103,3320807,3321937,N-acetyltransferase,1130
SARO_RS15765,Saro_3104,3321945,3322712,glycerophosphoryl diester phosphodiesterase,767
SARO_RS15770,Saro_3105,3322693,3323211,RidA family protein,518
SARO_RS15775,Saro_3106,3323157,3323786,hypothetical protein,629
SARO_RS15780,Saro_3107,3323783,3324058,DUF3572 domain-containing protein,275
SARO_RS15785,Saro_3108,3324134,3324496,response regulator,362
SARO_RS15790,Saro_3109,3324517,3325101,hypothetical protein,584
SARO_RS15795,Saro_3110,3325240,3325479,acyl carrier protein,239
SARO_RS15800,Saro_3111,3325484,3326683,aminotransferase class V-fold PLP-dependent enzyme,1199
SARO_RS15805,NA,3326683,3327546,GDSL family lipase,863
SARO_RS15810,Saro_3113,3327559,3328107,ribosomal large subunit pseudouridine synthase E,548
SARO_RS15815,Saro_3114,3328116,3328736,glutathione S-transferase,620
SARO_RS20345,Saro_3115,3328925,3329791,MipA/OmpV family protein,866
SARO_RS15825,Saro_3116,3329801,3330448,DedA family protein,647
SARO_RS15830,Saro_3117,3330666,3331166,hypothetical protein,500
SARO_RS15835,Saro_3118,3331159,3332481,ATP-binding protein,1322
SARO_RS15840,Saro_3119,3332560,3333729,phage portal protein,1169
SARO_RS15845,Saro_3120,3333726,3334034,hypothetical protein,308
SARO_RS15850,Saro_3121,3334031,3334483,HK97 family phage prohead protease,452
SARO_RS15855,Saro_3122,3334561,3335703,phage major capsid protein,1142
SARO_RS15860,Saro_3123,3335824,3336375,hypothetical protein,551
SARO_RS15865,NA,3336342,3336530,hypothetical protein,188
SARO_RS15870,Saro_3124,3336535,3336930,DUF3168 domain-containing protein,395
SARO_RS15875,Saro_3125,3336959,3337366,phage major tail protein%2C TP901-1 family,407
SARO_RS15880,Saro_3126,3337366,3337680,gene transfer agent family protein,314
SARO_RS15885,NA,3337677,3337877,phage tail assembly chaperone,200
SARO_RS15890,Saro_3128,3337867,3338448,hypothetical protein,581
SARO_RS15895,Saro_3129,3338468,3340807,TIGR02217 family protein,2339
SARO_RS15900,Saro_3130,3340804,3341625,DUF2163 domain-containing protein,821
SARO_RS15905,Saro_3131,3341622,3342017,hypothetical protein,395
SARO_RS15910,Saro_3132,3342011,3344215,hypothetical protein,2204
SARO_RS15915,Saro_3133,3344239,3344697,DUF2793 domain-containing protein,458
SARO_RS15920,Saro_3134,3344891,3345964,flagellar motor protein MotB,1073
SARO_RS15925,Saro_3135,3346022,3346597,superoxide dismutase family protein,575
SARO_RS15930,Saro_3136,3346614,3348206,MFS transporter,1592
SARO_RS15935,Saro_3137,3348178,3348879,7-cyano-7-deazaguanine synthase,701
SARO_RS15940,NA,3348941,3349372,hypothetical protein,431
SARO_RS15945,Saro_3139,3349503,3350417,molecular chaperone Hsp33,914
SARO_RS15950,Saro_3140,3350414,3351349,ornithine carbamoyltransferase,935
SARO_RS15955,Saro_3141,3351346,3352539,acetylornithine transaminase,1193
SARO_RS15960,Saro_3142,3352715,3353518,cold-shock protein,803
SARO_RS15965,Saro_3143,3353813,3354247,TIGR01244 family phosphatase,434
SARO_RS15970,Saro_3144,3354272,3354703,hypothetical protein,431
SARO_RS15975,Saro_3145,3354700,3355593,sterol desaturase family protein,893
SARO_RS15980,Saro_3146,3355580,3356191,TetR/AcrR family transcriptional regulator,611
SARO_RS15985,Saro_3147,3356399,3358726,TonB-dependent receptor,2327
SARO_RS15990,Saro_3148,3359153,3360457,UDP-N-acetyl-D-mannosamine dehydrogenase,1304
SARO_RS15995,Saro_3149,3360447,3361565,UDP-N-acetylglucosamine 2-epimerase (non-hydrolyzing),1118
SARO_RS16000,Saro_3150,3361673,3362998,nucleotide sugar dehydrogenase,1325
SARO_RS16005,Saro_3151,3363104,3364102,KR domain-containing protein,998
SARO_RS16010,Saro_3152,3364131,3364523,hypothetical protein,392
SARO_RS16015,Saro_3153,3364643,3365686,agmatine deiminase family protein,1043
SARO_RS16020,Saro_3154,3365728,3368436,bifunctional [glutamate--ammonia ligase]-adenylyl-L-tyrosine phosphorylase/[glutamate--ammonia-ligase] adenylyltransferase,2708
SARO_RS16025,Saro_3155,3368433,3368906,peroxiredoxin,473
SARO_RS16030,Saro_3156,3368961,3369755,DUF455 domain-containing protein,794
SARO_RS16035,Saro_3157,3369948,3370664,M23 family peptidase,716
SARO_RS16040,Saro_3158,3370779,3371468,spermidine synthase,689
SARO_RS16045,Saro_3159,3371606,3372700,hypothetical protein,1094
SARO_RS16050,NA,3372723,3373298,beta-Ig-H3/fasciclin,575
SARO_RS16055,Saro_3161,3373450,3375000,acyl-CoA synthetase,1550
SARO_RS16060,Saro_3162,3375020,3376312,cytochrome P450,1292
SARO_RS16065,Saro_3163,3376371,3377777,MFS transporter,1406
SARO_RS16070,Saro_3164,3378071,3379762,GMC family oxidoreductase,1691
SARO_RS16075,NA,3379785,3380327,twin-arginine translocation pathway signal protein,542
SARO_RS16080,Saro_3166,3380417,3381637,MFS transporter,1220
SARO_RS16085,Saro_3167,3381637,3382617,sugar phosphate isomerase/epimerase,980
SARO_RS16090,Saro_3168,3383015,3383947,electron transfer flavoprotein subunit alpha/FixB family protein,932
SARO_RS16095,Saro_3169,3383947,3384699,electron transfer flavoprotein subunit beta/FixA family protein,752
SARO_RS16100,Saro_3170,3384930,3386129,succinyl-CoA ligase subunit beta,1199
SARO_RS16105,Saro_3171,3386353,3387129,3'(2')%2C5'-bisphosphate nucleotidase CysQ,776
SARO_RS16110,Saro_3172,3387136,3388131,aldo/keto reductase,995
SARO_RS16115,Saro_3173,3388263,3388955,OmpA/MotB,692
SARO_RS16120,Saro_3174,3389136,3390464,HlyC/CorC family transporter,1328
SARO_RS16125,Saro_3175,3390562,3391995,glutamate synthase subunit beta,1433
SARO_RS16130,Saro_3176,3392022,3396662,glutamate synthase large subunit,4640
SARO_RS16135,Saro_3177,3396868,3398406,hypothetical protein,1538
SARO_RS16140,Saro_3178,3398543,3399751,glycosyltransferase%2C exosortase A system-associated,1208
SARO_RS16145,Saro_3179,3399971,3401332,putative O-glycosylation ligase%2C exosortase A system-associated,1361
SARO_RS16150,Saro_3180,3401412,3401873,MaoC family dehydratase,461
SARO_RS16155,Saro_3181,3401890,3402426,DUF3237 domain-containing protein,536
SARO_RS16160,Saro_3182,3402497,3403753,polyhydroxyalkanoate depolymerase,1256
SARO_RS16165,Saro_3183,3403904,3405715,ABC transporter ATP-binding protein,1811
SARO_RS16170,Saro_3184,3405807,3406619,undecaprenyl-diphosphatase,812
SARO_RS16175,Saro_3185,3406716,3406982,GlsB/YeaQ/YmgE family stress response membrane protein,266
SARO_RS16180,Saro_3186,3407063,3407347,hypothetical protein,284
SARO_RS16185,Saro_3187,3407491,3408381,phenylalanine 4-monooxygenase,890
SARO_RS16190,Saro_3188,3408604,3408771,50S ribosomal protein L33,167
SARO_RS16195,Saro_3189,3408868,3409554,outer membrane lipoprotein carrier protein LolA,686
SARO_RS16200,Saro_3190,3409927,3410718,exodeoxyribonuclease III,791
SARO_RS16205,Saro_3191,3410715,3411779,GTP cyclohydrolase II,1064
SARO_RS16210,Saro_3192,3411879,3412181,hypothetical protein,302
SARO_RS16215,Saro_3193,3412230,3412523,hypothetical protein,293
SARO_RS16220,Saro_3194,3412609,3413604,hypothetical protein,995
SARO_RS16225,Saro_3195,3413686,3413988,hypothetical protein,302
SARO_RS16230,Saro_3196,3413981,3414193,hypothetical protein,212
SARO_RS16235,Saro_3197,3414207,3415115,membrane protein,908
SARO_RS20745,Saro_3198,3415457,3415633,DUF465 domain-containing protein,176
SARO_RS16240,Saro_3199,3415696,3416685,TerC family protein,989
SARO_RS16245,Saro_3200,3416729,3418531,DNA helicase RecQ,1802
SARO_RS16250,Saro_3201,3418559,3419029,nuclear transport factor 2 family protein,470
SARO_RS16255,Saro_3202,3419089,3419604,hypothetical protein,515
SARO_RS16260,Saro_3203,3419630,3420823,sodium:proton exchanger,1193
SARO_RS16265,Saro_3204,3420940,3421236,hypothetical protein,296
SARO_RS16270,Saro_3205,3421366,3421638,hypothetical protein,272
SARO_RS16275,Saro_3206,3421708,3424344,methionine synthase,2636
SARO_RS16280,Saro_3207,3424461,3425516,5-methyltetrahydrofolate--homocysteine methyltransferase,1055
SARO_RS16285,Saro_3208,3425534,3426475,methylenetetrahydrofolate reductase [NAD(P)H],941
SARO_RS16290,Saro_3209,3426482,3427507,methyltransferase domain-containing protein,1025
SARO_RS16295,NA,3427706,3428011,hypothetical protein,305
SARO_RS16300,NA,3428075,3428275,hypothetical protein,200
SARO_RS20750,Saro_3211,3428245,3428502,aryl-sulfate sulfotransferase,257
SARO_RS16305,Saro_3212,3428543,3429265,beta-ketoacyl-ACP reductase,722
SARO_RS16310,Saro_3213,3429441,3430181,hypothetical protein,740
SARO_RS16315,Saro_3214,3430597,3431061,DUF3576 domain-containing protein,464
SARO_RS16320,Saro_3215,3431111,3433657,leucine--tRNA ligase,2546
SARO_RS16325,Saro_3216,3433689,3434150,hypothetical protein,461
SARO_RS16330,Saro_3217,3434161,3435183,DNA polymerase III subunit delta,1022
SARO_RS16335,Saro_3218,3435376,3436779,sugar transferase,1403
SARO_RS16340,Saro_3219,3436809,3437657,hypothetical protein,848
SARO_RS16345,NA,3437626,3437868,hypothetical protein,242
SARO_RS16350,Saro_3220,3437998,3439263,nucleotide sugar dehydrogenase,1265
SARO_RS20865,Saro_3221,3439314,3440513,glycosyltransferase WbuB,1199
SARO_RS20870,Saro_3222,3440545,3441090,hypothetical protein,545
SARO_RS16365,Saro_3223,3441276,3441989,sugar transporter,713
SARO_RS16370,Saro_3224,3442033,3444234,protein-tyrosine kinase,2201
SARO_RS16375,Saro_3225,3444277,3445527,group 1 glycosyl transferase,1250
SARO_RS16380,Saro_3226,3445570,3446523,glycosyltransferase family 2 protein,953
SARO_RS16385,Saro_3227,3446520,3447704,acyltransferase,1184
SARO_RS16390,Saro_3228,3447652,3449031,hypothetical protein,1379
SARO_RS16395,Saro_3229,3449113,3449382,hypothetical protein,269
SARO_RS16400,Saro_3230,3449382,3451442,hypothetical protein,2060
SARO_RS16405,Saro_3231,3451482,3452762,hypothetical protein,1280
SARO_RS16410,Saro_3232,3452750,3453721,class I SAM-dependent methyltransferase,971
SARO_RS16415,Saro_3233,3453763,3455235,flippase,1472
SARO_RS16420,Saro_3234,3455384,3456517,polysaccharide biosynthesis protein,1133
SARO_RS16425,Saro_3235,3456553,3457611,dTDP-glucose 4%2C6-dehydratase,1058
SARO_RS16430,Saro_3236,3457604,3458461,dTDP-4-dehydrorhamnose reductase,857
SARO_RS16435,Saro_3237,3458458,3459003,dTDP-4-dehydrorhamnose 3%2C5-epimerase,545
SARO_RS16440,Saro_3238,3459000,3459905,glucose-1-phosphate thymidylyltransferase,905
SARO_RS16445,Saro_3239,3460109,3461353,hypothetical protein,1244
SARO_RS16450,Saro_3240,3461337,3463055,ABC transporter ATP-binding protein,1718
SARO_RS16455,Saro_3241,3463030,3464979,asparagine synthetase B family protein,1949
SARO_RS20760,Saro_3242,3464976,3465566,hypothetical protein,590
SARO_RS16465,Saro_3243,3465481,3465750,PqqD family protein,269
SARO_RS20350,Saro_3244,3466034,3466894,HPr kinase,860
SARO_RS16475,Saro_3246,3467290,3467547,hypothetical protein,257
SARO_RS16480,Saro_3247,3467726,3469084,O-antigen ligase domain-containing protein,1358
SARO_RS20355,Saro_3248,3469081,3469791,hypothetical protein,710
SARO_RS16490,Saro_3249,3469832,3470386,hypothetical protein,554
SARO_RS16495,Saro_3250,3470383,3471027,hypothetical protein,644
SARO_RS16500,Saro_3251,3471052,3471669,ribonuclease D,617
SARO_RS16505,Saro_3252,3471830,3472744,sulfate adenylyltransferase subunit CysD,914
SARO_RS16510,Saro_3253,3472744,3474678,adenylyl-sulfate kinase,1934
SARO_RS16515,NA,3474721,3475002,DUF2061 domain-containing protein,281
SARO_RS16520,Saro_3255,3475038,3476342,UDP-glucose/GDP-mannose dehydrogenase family protein,1304
SARO_RS16525,Saro_3256,3476471,3477151,uracil-DNA glycosylase,680
SARO_RS16530,Saro_3257,3477222,3477635,DUF3035 domain-containing protein,413
SARO_RS16535,Saro_3258,3477635,3478150,signal peptidase II,515
SARO_RS16540,Saro_3259,3478150,3481056,isoleucine--tRNA ligase,2906
SARO_RS16545,Saro_3260,3481250,3482170,bifunctional riboflavin kinase/FAD synthetase,920
SARO_RS16550,Saro_3261,3482170,3483354,peptidase M19,1184
SARO_RS16555,Saro_3262,3483378,3483887,dihydrofolate reductase,509
SARO_RS16560,Saro_3263,3483884,3484942,5-(carboxyamino)imidazole ribonucleotide synthase,1058
SARO_RS16565,Saro_3264,3484957,3485442,5-(carboxyamino)imidazole ribonucleotide mutase,485
SARO_RS16570,Saro_3265,3485472,3486158,2%2C3-bisphosphoglycerate-dependent phosphoglycerate mutase,686
SARO_RS16575,NA,3486204,3486383,hypothetical protein,179
SARO_RS16585,Saro_3266,3486624,3486914,N-acetyltransferase,290
SARO_RS16590,Saro_3267,3486981,3487997,amino acid lyase,1016
SARO_RS16595,Saro_3268,3487994,3488917,EamA family transporter,923
SARO_RS16600,Saro_3269,3488827,3489675,epimerase,848
SARO_RS16605,Saro_3270,3489731,3492346,aminopeptidase N,2615
SARO_RS16610,Saro_3271,3492343,3493101,peptidoglycan editing factor PgeF,758
SARO_RS16615,Saro_3272,3493098,3493721,hydrolase,623
SARO_RS16620,Saro_3273,3493829,3493954,50S ribosomal protein L36,125
SARO_RS16625,Saro_3274,3494090,3494899,hypothetical protein,809
SARO_RS16630,Saro_3275,3494893,3495894,UDP-glucose 4-epimerase GalE,1001
SARO_RS16635,NA,3496015,3496704,DUF4136 domain-containing protein,689
SARO_RS16640,Saro_3277,3496835,3497428,DUF4136 domain-containing protein,593
SARO_RS16645,Saro_3278,3497425,3498555,hypothetical protein,1130
SARO_RS16650,Saro_3279,3498762,3499103,arsenate reductase (glutaredoxin),341
SARO_RS16655,Saro_3280,3499265,3501388,TonB-dependent siderophore receptor,2123
SARO_RS16660,Saro_3281,3501473,3501982,(2Fe-2S)-binding protein,509
SARO_RS16665,Saro_3282,3502015,3502779,class II aldolase,764
SARO_RS16670,Saro_3283,3502808,3503434,DUF159 family protein,626
SARO_RS16675,Saro_3284,3503438,3504133,HPP family protein,695
SARO_RS16680,Saro_3285,3504255,3504797,30S ribosomal protein S9,542
SARO_RS16685,Saro_3286,3504800,3505279,50S ribosomal protein L13,479
SARO_RS16690,Saro_3287,3505418,3505744,divalent-cation tolerance protein CutA,326
SARO_RS16695,Saro_3288,3505741,3506793,heme A synthase,1052
SARO_RS16700,Saro_3289,3506969,3507340,MerC domain-containing protein,371
SARO_RS16705,NA,3507383,3508378,thiamine biosynthesis protein ThiS,995
SARO_RS16710,Saro_3291,3508428,3510692,NADP-dependent malic enzyme,2264
SARO_RS16715,Saro_3292,3510824,3512479,hypothetical protein,1655
SARO_RS16720,Saro_3293,3512607,3515183,DNA mismatch repair protein MutS,2576
SARO_RS16725,Saro_3294,3515176,3515790,5'-methylthioadenosine/S-adenosylhomocysteine nucleosidase,614
SARO_RS16730,Saro_3295,3515840,3517096,NupC/NupG family nucleoside CNT transporter,1256
SARO_RS16735,Saro_3296,3517186,3517851,membrane protein,665
SARO_RS16740,Saro_3297,3517962,3518873,acetylglutamate kinase,911
SARO_RS16745,NA,3518914,3519105,hypothetical protein,191
SARO_RS16750,NA,3519104,3519457,hypothetical protein,353
SARO_RS16755,Saro_3299,3519646,3519945,YggT family protein,299
SARO_RS16760,Saro_3300,3519973,3520866,bifunctional methylenetetrahydrofolate dehydrogenase/methenyltetrahydrofolate cyclohydrolase,893
SARO_RS16765,Saro_3301,3521161,3521565,acyl-CoA thioesterase,404
SARO_RS16770,Saro_3302,3521569,3521748,hypothetical protein,179
SARO_RS16775,Saro_3303,3521752,3522489,bifunctional 2-polyprenyl-6-hydroxyphenol methylase/3-demethylubiquinol 3-O-methyltransferase UbiG,737
SARO_RS16780,Saro_3304,3522575,3523831,aspartate kinase,1256
SARO_RS16785,Saro_3305,3523876,3524550,pentapeptide repeat-containing protein,674
SARO_RS16790,Saro_3306,3524917,3525945,2-nitropropane dioxygenase,1028
SARO_RS16795,Saro_3307,3525997,3527214,tetracycline resistance MFS efflux pump,1217
SARO_RS16800,Saro_3308,3527377,3528012,HNH endonuclease,635
SARO_RS16805,Saro_3309,3528182,3529600,peptidase M20,1418
SARO_RS16810,Saro_3310,3529785,3532292,DNA topoisomerase (ATP-hydrolyzing) subunit B,2507
SARO_RS16815,Saro_3311,3532337,3532546,hypothetical protein,209
SARO_RS16820,Saro_3312,3532565,3534988,DNA ligase-associated DEXH box helicase,2423
SARO_RS16825,Saro_3313,3535002,3536780,hypothetical protein,1778
SARO_RS16830,Saro_3314,3536777,3538483,molecular chaperone HscC,1706
SARO_RS20765,Saro_3315,3538903,3539553,BON domain-containing protein,650
SARO_RS16840,Saro_3316,3539560,3540963,phosphomannomutase/phosphoglucomutase,1403
SARO_RS16845,Saro_3317,3541039,3541335,molecular chaperone DnaJ,296
SARO_RS16850,Saro_3318,3541335,3542159,ATPase,824
SARO_RS16855,Saro_3319,3542259,3543119,pantoate--beta-alanine ligase,860
SARO_RS16860,Saro_3320,3543116,3543460,DUF2322 domain-containing protein,344
SARO_RS16865,Saro_3321,3543483,3544331,metallophosphoesterase,848
SARO_RS16870,Saro_3322,3544391,3545242,hypothetical protein,851
SARO_RS16875,Saro_3323,3545279,3545545,hypothetical protein,266
SARO_RS20770,NA,3545579,3546109,UrcA family protein,530
SARO_RS16885,NA,3546220,3546669,transcriptional regulator,449
SARO_RS16890,Saro_3326,3546871,3547224,hypothetical protein,353
SARO_RS20370,Saro_3327,3547376,3548014,hypothetical protein,638
SARO_RS16900,Saro_3328,3548061,3548468,peptide-methionine (R)-S-oxide reductase,407
SARO_RS16905,Saro_3329,3548577,3550715,penicillin-binding protein,2138
SARO_RS16910,Saro_3330,3550784,3551026,hypothetical protein,242
SARO_RS16915,Saro_3331,3551124,3552605,PDZ domain-containing protein,1481
SARO_RS16920,Saro_3332,3552814,3553665,protease modulator HflC,851
SARO_RS16925,Saro_3333,3553667,3554791,FtsH protease activity modulator HflK,1124
SARO_RS16930,Saro_3334,3555037,3555906,chromosome partitioning protein ParA,869
SARO_RS16935,Saro_3335,3555912,3558212,xanthine dehydrogenase family protein molybdopterin-binding subunit,2300
SARO_RS16940,Saro_3336,3558219,3559232,ferrochelatase,1013
SARO_RS16945,Saro_3337,3559319,3560713,cytochrome P450,1394
SARO_RS16950,Saro_3338,3560825,3561085,30S ribosomal protein S20,260
SARO_RS16970,Saro_3833,27,1037,amidohydrolase,1010
SARO_RS16975,Saro_3834,1097,1594,aromatic-ring-hydroxylating dioxygenase subunit beta,497
SARO_RS16980,Saro_3835,1591,2766,aromatic ring-hydroxylating dioxygenase subunit alpha,1175
SARO_RS16985,Saro_3836,2809,3795,aldolase,986
SARO_RS16990,Saro_3837,3947,4735,1%2C6-dihydroxycyclohexa-2%2C4-diene-1-carboxylate dehydrogenase,788
SARO_RS16995,Saro_3838,4755,5981,pyridine nucleotide-disulfide oxidoreductase,1226
SARO_RS17000,Saro_3839,6095,7735,sigma-54-dependent Fis family transcriptional regulator,1640
SARO_RS17005,Saro_3840,7948,9300,aromatic ring-hydroxylating dioxygenase subunit alpha,1352
SARO_RS17010,Saro_3841,9293,9820,aromatic-ring-hydroxylating dioxygenase subunit beta,527
SARO_RS17015,Saro_3842,9846,11213,aromatic ring-hydroxylating dioxygenase subunit alpha,1367
SARO_RS17020,Saro_3843,11228,11779,3-phenylpropionate dioxygenase,551
SARO_RS17030,Saro_3845,14490,15593,alkane 1-monooxygenase,1103
SARO_RS17035,Saro_3846,15676,16716,oxidoreductase,1040
SARO_RS17040,Saro_3847,16776,17576,3-(cis-5%2C6-dihydroxycyclohexa-1%2C3-dien-1-yl)propanoate dehydrogenase,800
SARO_RS17045,Saro_3848,17608,19113,aldehyde dehydrogenase,1505
SARO_RS17050,Saro_3849,19133,19414,ferredoxin,281
SARO_RS17055,Saro_3850,19404,19646,4-oxalocrotonate tautomerase,242
SARO_RS17060,Saro_3851,19648,20418,4-oxalocrotonate decarboxylase,770
SARO_RS17065,Saro_3852,20420,21451,4-hydroxy-2-oxovalerate aldolase,1031
SARO_RS17070,Saro_3853,21448,22386,acetaldehyde dehydrogenase,938
SARO_RS17075,Saro_3854,22409,23203,2-keto-4-pentenoate hydratase,794
SARO_RS17080,Saro_3855,23208,24692,2-hydroxymuconic semialdehyde dehydrogenase,1484
SARO_RS17085,Saro_3856,24732,25163,heme-binding protein,431
SARO_RS17090,Saro_3857,25166,26089,catechol 2%2C3-dioxygenase,923
SARO_RS17095,Saro_3858,26108,26959,2-hydroxy-6-oxo-2%2C4-heptadienoate hydrolase,851
SARO_RS17100,Saro_3859,27129,27734,glutathione transferase GstA,605
SARO_RS17105,Saro_3860,27776,28264,anthranilate 1%2C2-dioxygenase small subunit,488
SARO_RS17110,Saro_3861,28261,29541,(2Fe-2S)-binding protein,1280
SARO_RS17115,Saro_3862,29552,30544,4-hydroxythreonine-4-phosphate dehydrogenase,992
SARO_RS17120,Saro_3863,30528,31022,small subunit toluate/benzoate dioxygenase,494
SARO_RS17125,Saro_3864,31022,32437,large subunit toluate/benzoate dioxygenase,1415
SARO_RS17130,Saro_3865,32668,33567,biphenyl-2%2C3-diol 1%2C2-dioxygenase,899
SARO_RS17135,Saro_3866,33613,33939,non-heme iron oxygenase ferredoxin subunit,326
SARO_RS17140,Saro_3867,33936,34427,anthranilate 1%2C2-dioxygenase small subunit,491
SARO_RS17145,Saro_3868,34452,35714,(2Fe-2S)-binding protein,1262
SARO_RS17150,Saro_3869,35711,36304,2-hydroxychromene-2-carboxylate isomerase,593
SARO_RS17155,Saro_3870,36333,38513,TonB-dependent receptor,2180
SARO_RS17160,Saro_3871,38624,41122,TonB-dependent receptor,2498
SARO_RS17165,Saro_3872,41255,42727,NAD-dependent succinate-semialdehyde dehydrogenase,1472
SARO_RS17170,Saro_3873,42885,43499,UbiX family flavin prenyltransferase,614
SARO_RS17175,Saro_3874,43502,44074,hypothetical protein,572
SARO_RS17180,Saro_3875,44083,45630,FAD-binding protein,1547
SARO_RS17185,Saro_3876,45672,47111,aldehyde dehydrogenase,1439
SARO_RS17190,Saro_3877,47125,48585,UbiD family decarboxylase,1460
SARO_RS17195,Saro_3878,48582,48806,hypothetical protein,224
SARO_RS17200,Saro_3879,48820,50286,FAD-binding oxidoreductase,1466
SARO_RS17205,Saro_3880,50318,50683,cytochrome c,365
SARO_RS17220,Saro_3883,52202,52705,TIGR02444 family protein,503
SARO_RS17225,Saro_3884,52825,53685,2-hydroxy-6-oxo-6-phenylhexa-2%2C4-dienoate hydrolase,860
SARO_RS17230,Saro_3885,53825,54640,2-oxo-hepta-3-ene-1%2C7-dioic acid hydratase,815
SARO_RS17235,Saro_3886,54650,55438,4-hydroxy-2-oxovalerate aldolase,788
SARO_RS17240,Saro_3887,55441,56607,CoA transferase,1166
SARO_RS17245,Saro_3888,56617,57801,MFS transporter,1184
SARO_RS17250,Saro_3889,57950,58756,IclR family transcriptional regulator,806
SARO_RS17255,Saro_3890,58995,59924,fatty acid desaturase,929
SARO_RS17260,Saro_3891,59987,61306,LLM class flavin-dependent oxidoreductase,1319
SARO_RS17265,Saro_3892,61311,62243,2-dehydropantoate 2-reductase,932
SARO_RS17270,Saro_3893,62244,62654,hypothetical protein,410
SARO_RS17275,Saro_3894,62665,62949,DUF1330 domain-containing protein,284
SARO_RS17280,Saro_3895,62994,64061,tartrate dehydrogenase,1067
SARO_RS17285,Saro_3896,64075,65088,ketopantoate reductase family protein,1013
SARO_RS17290,Saro_3897,65114,66076,dihydrodipicolinate synthase family protein,962
SARO_RS17295,Saro_3898,66130,68796,pyruvate%2C phosphate dikinase,2666
SARO_RS17300,Saro_3899,68869,69966,NAD(P)-dependent alcohol dehydrogenase,1097
SARO_RS17305,Saro_3900,70009,70533,aromatic-ring-hydroxylating dioxygenase subunit beta,524
SARO_RS17310,Saro_3901,70559,71938,aromatic ring-hydroxylating dioxygenase subunit alpha,1379
SARO_RS17315,Saro_3902,72076,73005,EamA/RhaT family transporter,929
SARO_RS17320,Saro_3903,73068,74597,MFS transporter,1529
SARO_RS17325,Saro_3904,74604,75749,EmrA/EmrK family multidrug efflux transporter periplasmic adaptor subunit,1145
SARO_RS17330,Saro_3905,75746,77197,multidrug transporter,1451
SARO_RS17335,Saro_3906,77187,77600,thioesterase,413
SARO_RS17340,Saro_3907,77597,78481,alpha/beta hydrolase,884
SARO_RS17345,Saro_3908,78556,79002,MarR family transcriptional regulator,446
SARO_RS20380,Saro_3909,79189,79506,DUF2062 domain-containing protein,317
SARO_RS20775,Saro_3910,79553,79744,hypothetical protein,191
SARO_RS20780,Saro_3911,79851,80144,hypothetical protein,293
SARO_RS20385,Saro_3912,80185,80592,ECF subfamily RNA polymerase sigma-24 factor,407
SARO_RS17360,Saro_3913,80641,80877,hypothetical protein,236
SARO_RS17365,Saro_3914,80901,81788,recombinase family protein,887
SARO_RS17370,Saro_3915,82037,82975,hypothetical protein,938
SARO_RS17375,Saro_3916,82982,83260,WGR domain-containing protein,278
SARO_RS17380,Saro_3917,83388,84371,chromosome partitioning protein ParB,983
SARO_RS17385,Saro_3918,84603,85808,chromosome partitioning protein,1205
SARO_RS17390,Saro_3919,86362,87666,hypothetical protein,1304
SARO_RS17395,Saro_3920,87740,88582,topoisomerase,842
SARO_RS17400,Saro_3921,88651,92880,methylase,4229
SARO_RS17405,Saro_3922,92867,94006,DUF4172 domain-containing protein,1139
SARO_RS17410,Saro_3923,94243,94833,PIN domain-containing protein,590
SARO_RS17415,Saro_3924,94846,95304,helix-turn-helix domain-containing protein,458
SARO_RS17420,Saro_3925,95510,97582,chromosome partitioning protein ParB,2072
SARO_RS17425,Saro_3926,97655,99322,ATP-binding protein,1667
SARO_RS17435,Saro_3928,100332,102233,RNA-directed DNA polymerase,1901
SARO_RS17445,Saro_3929,102783,104174,integrase,1391
SARO_RS17450,Saro_3930,104171,105958,hypothetical protein,1787
SARO_RS17455,Saro_3931,105955,108180,integrase,2225
SARO_RS17460,Saro_3932,108243,109127,DUF1738 domain-containing protein,884
SARO_RS17465,Saro_3933,109124,109396,hypothetical protein,272
SARO_RS17470,Saro_3934,109484,110140,hypothetical protein,656
SARO_RS17475,Saro_3935,110152,110439,hypothetical protein,287
SARO_RS17480,Saro_3937,111024,112865,RNA-directed DNA polymerase,1841
SARO_RS17485,NA,112862,113305,hypothetical protein,443
SARO_RS17490,Saro_3939,113329,113553,hypothetical protein,224
SARO_RS17495,Saro_3940,113558,114046,hypothetical protein,488
SARO_RS17500,Saro_3941,114157,114564,DUF3768 domain-containing protein,407
SARO_RS17505,Saro_3942,114569,114880,hypothetical protein,311
SARO_RS17510,Saro_3943,114946,116901,hypothetical protein,1955
SARO_RS17515,Saro_3944,116898,118499,hypothetical protein,1601
SARO_RS17520,Saro_3945,118850,119857,DGQHR domain-containing protein,1007
SARO_RS17525,Saro_3946,119857,121470,radical SAM protein,1613
SARO_RS17530,Saro_3947,121467,122990,heat-shock protein Hsp90,1523
SARO_RS17535,Saro_3948,123039,125348,DGQHR domain-containing protein,2309
SARO_RS20785,Saro_3949,125521,125886,hypothetical protein,365
SARO_RS17540,Saro_3950,126035,126583,DUF736 domain-containing protein,548
SARO_RS17545,Saro_3951,126742,127098,hypothetical protein,356
SARO_RS17550,Saro_3952,127115,127306,hypothetical protein,191
SARO_RS17555,Saro_3953,127393,127998,DUF159 family protein,605
SARO_RS17560,Saro_3954,128061,128501,hypothetical protein,440
SARO_RS17565,Saro_3955,128513,128836,hypothetical protein,323
SARO_RS17570,Saro_3956,128880,129392,hypothetical protein,512
SARO_RS17575,Saro_3957,129491,129994,hypothetical protein,503
SARO_RS17580,Saro_3958,130001,131227,DUF1173 domain-containing protein,1226
SARO_RS17585,Saro_3959,131387,131971,hypothetical protein,584
SARO_RS17590,Saro_3960,132018,132707,pentapeptide repeat-containing protein,689
SARO_RS17595,Saro_3961,132704,133249,sigma-70 family RNA polymerase sigma factor,545
SARO_RS17600,Saro_3962,133252,133476,DUF2892 domain-containing protein,224
SARO_RS17605,Saro_3963,133609,133794,hypothetical protein,185
SARO_RS17610,Saro_3964,134118,134462,nuclease,344
SARO_RS20790,Saro_3965,134522,134713,hypothetical protein,191
SARO_RS17615,Saro_3966,134925,135260,single-stranded DNA-binding protein,335
SARO_RS17620,Saro_3967,135547,136026,MucR family transcriptional regulator,479
SARO_RS17625,Saro_3968,136237,136716,hypothetical protein,479
SARO_RS17630,Saro_3969,136713,138845,integrase,2132
SARO_RS17635,Saro_3970,138836,140002,integrase,1166
SARO_RS17640,Saro_3971,140284,140529,AbrB/MazE/SpoVT family DNA-binding domain-containing protein,245
SARO_RS17645,Saro_3972,140526,140915,PIN domain-containing protein,389
SARO_RS17650,Saro_3973,140931,141803,hypothetical protein,872
SARO_RS17655,Saro_3974,141816,142091,hypothetical protein,275
SARO_RS17660,Saro_3975,142111,143598,cell filamentation protein Fic,1487
SARO_RS20795,Saro_3976,143702,144445,hypothetical protein,743
SARO_RS17665,Saro_3977,144531,145625,DUF2493 domain-containing protein,1094
SARO_RS20800,Saro_3978,145679,146062,hypothetical protein,383
SARO_RS17670,Saro_3979,146059,146370,hypothetical protein,311
SARO_RS17675,NA,146499,146726,hypothetical protein,227
SARO_RS17680,Saro_3981,147181,147471,hypothetical protein,290
SARO_RS17685,Saro_3982,147458,149788,type IV secretory protein VirD4,2330
SARO_RS17690,Saro_3983,149792,152833,conjugative relaxase,3041
SARO_RS17695,Saro_3984,152830,153072,hypothetical protein,242
SARO_RS17700,Saro_3985,153075,153278,hypothetical protein,203
SARO_RS17705,Saro_3986,153295,153654,hypothetical protein,359
SARO_RS17710,Saro_3987,153763,156204,hypothetical protein,2441
SARO_RS17715,Saro_3988,156310,156525,hypothetical protein,215
SARO_RS17720,Saro_3989,156771,156956,hypothetical protein,185
SARO_RS17725,Saro_3990,156959,157729,GntR family transcriptional regulator,770
SARO_RS17730,Saro_3991,157917,158579,FCD domain-containing protein,662
SARO_RS20805,Saro_3992,158684,158905,hypothetical protein,221
SARO_RS17735,NA,158910,159203,hypothetical protein,293
SARO_RS20810,Saro_3994,159346,160292,IS630 family transposase,946
SARO_RS20810,Saro_3994,159346,160292,IS630 family transposase,946
SARO_RS17755,Saro_3995,163015,164469,conjugal transfer protein TraH,1454
SARO_RS17760,Saro_3996,164469,165281,thioredoxin family protein,812
SARO_RS17765,Saro_3997,165278,165688,hypothetical protein,410
SARO_RS17770,Saro_3998,165669,167783,conjugal transfer protein TraN,2114
SARO_RS17775,Saro_3999,167785,168549,type-F conjugative transfer system pilin assembly protein TrbC,764
SARO_RS17780,Saro_4000,168558,169580,conjugal transfer protein TraU,1022
SARO_RS17785,Saro_4001,169577,169843,hypothetical protein,266
SARO_RS17790,Saro_4002,169840,170535,type-F conjugative transfer system protein TraW,695
SARO_RS17795,Saro_4003,170532,171074,type VI secretion protein,542
SARO_RS17800,Saro_4004,171058,171639,hypothetical protein,581
SARO_RS17805,Saro_4005,171629,171991,hypothetical protein,362
SARO_RS17810,Saro_4006,171988,174594,VirB4 family type IV secretion/conjugal transfer ATPase,2606
SARO_RS17815,Saro_4007,174601,175752,hypothetical protein,1151
SARO_RS17820,Saro_4008,175749,176645,thiol:disulfide interchange protein DsbC,896
SARO_RS17825,Saro_4009,176656,178032,conjugal transfer protein TraB,1376
SARO_RS17830,Saro_4010,178032,178826,conjugal transfer protein TraK,794
SARO_RS17835,Saro_4011,178826,179449,conjugal transfer protein TraE,623
SARO_RS17840,Saro_4012,179463,179747,type IV conjugative transfer system protein TraL,284
SARO_RS17845,Saro_4013,179813,180127,hypothetical protein,314
SARO_RS17850,NA,180466,180825,hypothetical protein,359
SARO_RS17855,NA,180915,181436,hypothetical protein,521
SARO_RS17860,Saro_4015,181447,181722,hypothetical protein,275
SARO_RS20815,Saro_4016,181689,182408,lytic transglycosylase domain-containing protein,719
SARO_RS17865,Saro_4017,182667,183335,diguanylate cyclase,668
SARO_RS17870,Saro_4018,183328,184026,dimethylmenaquinone methyltransferase,698
SARO_RS17875,Saro_4019,184019,184411,RidA family protein,392
SARO_RS17880,Saro_3401,52,1395,MFS transporter,1343
SARO_RS17885,Saro_3402,1392,2579,MFS transporter,1187
SARO_RS17890,Saro_3403,2678,4873,TonB-dependent receptor,2195
SARO_RS17895,Saro_3404,4890,6392,hypothetical protein,1502
SARO_RS17900,Saro_3405,6389,7174,hypothetical protein,785
SARO_RS17905,Saro_3406,7434,8309,OmpA family protein,875
SARO_RS17910,Saro_3407,8357,8833,Cys-tRNA(Pro) deacylase,476
SARO_RS17915,Saro_3408,8931,9386,nucleoside-diphosphate kinase,455
SARO_RS17920,Saro_3409,9375,10742,2-methylcitrate dehydratase,1367
SARO_RS17925,Saro_3410,10794,11822,hypothetical protein,1028
SARO_RS17930,Saro_3411,11819,12940,poly-gamma-glutamate biosynthesis protein,1121
SARO_RS17935,Saro_3412,13126,14343,amidohydrolase,1217
SARO_RS17940,Saro_3413,14340,15851,monooxygenase,1511
SARO_RS17945,Saro_3414,15848,16276,heme-binding protein,428
SARO_RS17950,Saro_3415,16273,17175,glyoxalase,902
SARO_RS17955,Saro_3416,17280,18113,FAA hydrolase family protein,833
SARO_RS17960,Saro_3417,18126,18983,alpha/beta hydrolase,857
SARO_RS17965,Saro_3418,18961,19914,rhodanese domain-containing protein,953
SARO_RS17970,Saro_3419,19955,21139,acyl-CoA dehydrogenase,1184
SARO_RS17975,Saro_3420,21234,21992,NAD(P)-dependent oxidoreductase,758
SARO_RS17980,Saro_3421,21989,22504,cupin domain-containing protein,515
SARO_RS17985,Saro_3422,22501,23445,2-keto-4-pentenoate hydratase,944
SARO_RS17990,Saro_3423,23612,24943,histidinol dehydrogenase,1331
SARO_RS17995,Saro_3424,24940,25698,KR domain-containing protein,758
SARO_RS18000,Saro_3425,25710,26873,alpha/beta hydrolase,1163
SARO_RS18005,Saro_3426,26878,27285,VOC family protein,407
SARO_RS18010,Saro_3427,27314,28402,glyoxalase/bleomycin resistance protein/dioxygenase,1088
SARO_RS18015,Saro_3428,28502,29620,FAD-binding protein,1118
SARO_RS18020,Saro_3429,29634,30656,hypothetical protein,1022
SARO_RS18025,Saro_3430,30778,31011,hypothetical protein,233
SARO_RS18030,Saro_3431,31008,32597,NAD(P)/FAD-dependent oxidoreductase,1589
SARO_RS18035,Saro_3432,32599,33408,NAD(P)-dependent oxidoreductase,809
SARO_RS18040,Saro_3433,33510,33935,transcriptional regulator,425
SARO_RS18045,Saro_3434,33942,34943,LysR family transcriptional regulator,1001
SARO_RS18050,Saro_3435,34962,35879,epimerase,917
SARO_RS18055,Saro_3436,35890,37278,sulfatase,1388
SARO_RS18060,Saro_3437,37354,39792,TonB-dependent receptor,2438
SARO_RS18065,Saro_3438,39873,41072,monooxygenase%2C FAD-binding,1199
SARO_RS18070,Saro_3439,41088,41801,NAD(P)-dependent oxidoreductase,713
SARO_RS18075,Saro_3440,41794,43002,MFS transporter,1208
SARO_RS18080,Saro_3441,43148,43807,maleylacetoacetate isomerase,659
SARO_RS18085,Saro_3442,43947,45128,aminotransferase class V-fold PLP-dependent enzyme,1181
SARO_RS18090,Saro_3443,45115,46083,3-carboxymuconate cyclase-like protein,968
SARO_RS18095,Saro_3444,46456,46725,hypothetical protein,269
SARO_RS18100,Saro_3445,46771,48534,permease,1763
SARO_RS18105,Saro_3446,48577,49164,hypothetical protein,587
SARO_RS18110,Saro_3447,49359,50144,enoyl-CoA hydratase,785
SARO_RS18115,Saro_3448,50211,50978,3-hydroxy-2-methylbutyryl-CoA dehydrogenase,767
SARO_RS18120,Saro_3449,51091,51720,TetR/AcrR family transcriptional regulator,629
SARO_RS18125,NA,51877,52557,phosphoribosyltransferase,680
SARO_RS18130,Saro_3451,52681,53124,thioredoxin TrxC,443
SARO_RS18135,Saro_3452,53192,55759,cation-translocating P-type ATPase,2567
SARO_RS18140,Saro_3453,55829,58399,TonB-dependent receptor,2570
SARO_RS20390,Saro_3454,58470,58976,MarR family transcriptional regulator,506
SARO_RS18150,Saro_3455,59040,60017,quinone oxidoreductase,977
SARO_RS18155,Saro_3456,60051,60383,aldehyde-activating protein,332
SARO_RS18160,Saro_3457,60453,61202,enoyl-CoA hydratase,749
SARO_RS18165,Saro_3458,61275,61688,nuclear transport factor 2 family protein,413
SARO_RS18170,Saro_3459,61797,62816,NADP-dependent oxidoreductase,1019
SARO_RS18175,Saro_3460,62816,63553,3-oxoacyl-ACP reductase,737
SARO_RS18180,Saro_3461,63550,64083,hypothetical protein,533
SARO_RS18185,Saro_3462,64095,64445,(2Fe-2S)-binding protein,350
SARO_RS18190,Saro_3463,64456,65460,zinc-binding alcohol dehydrogenase family protein,1004
SARO_RS18195,Saro_3464,65627,66055,nuclear transport factor 2 family protein,428
SARO_RS18200,Saro_3465,66068,67132,arsenical-resistance protein,1064
SARO_RS18205,Saro_3466,67132,67638,arsenate reductase ArsC,506
SARO_RS18210,Saro_3467,67635,68108,glyoxalase/bleomycin resistance/dioxygenase family protein,473
SARO_RS18215,Saro_3468,68105,68449,transcriptional regulator,344
SARO_RS18220,Saro_3469,68576,71050,TonB-dependent receptor,2474
SARO_RS18225,Saro_3470,71196,72206,NADP-dependent oxidoreductase,1010
SARO_RS18230,Saro_3471,72206,73006,hypothetical protein,800
SARO_RS18235,Saro_3472,73027,73791,NAD(P)-dependent oxidoreductase,764
SARO_RS18240,Saro_3473,73888,76248,TonB-dependent receptor,2360
SARO_RS18245,Saro_3474,76401,77423,NADP-dependent oxidoreductase,1022
SARO_RS18250,Saro_3475,77413,78129,NAD(P)-dependent oxidoreductase,716
SARO_RS18255,Saro_3476,78137,79759,sigma-54-dependent Fis family transcriptional regulator,1622
SARO_RS18260,Saro_3477,80103,80477,hypothetical protein,374
SARO_RS18265,Saro_3478,80474,80815,cytochrome c,341
SARO_RS18270,Saro_3479,80834,82414,FAD-binding oxidoreductase,1580
SARO_RS18275,Saro_3480,82436,82819,cytochrome c,383
SARO_RS18280,Saro_3481,82831,84285,salicylaldehyde dehydrogenase,1454
SARO_RS18285,Saro_3482,84410,85348,phenol degradation protein,938
SARO_RS18290,Saro_3483,85445,86629,(2Fe-2S)-binding protein,1184
SARO_RS18295,Saro_3484,86640,88049,aromatic ring-hydroxylating dioxygenase subunit alpha,1409
SARO_RS18300,Saro_3485,88214,88741,glyoxalase/bleomycin resistance/dioxygenase family protein,527
SARO_RS18305,Saro_3486,88758,89519,KR domain-containing protein,761
SARO_RS18310,Saro_3487,89664,90482,NAD(P)-dependent oxidoreductase,818
SARO_RS18315,Saro_3488,90487,91962,FAD-binding protein,1475
SARO_RS18320,Saro_3489,91970,93592,cyclohexanecarboxylate-CoA ligase,1622
SARO_RS18325,Saro_3490,93740,94918,(2Fe-2S)-binding protein,1178
SARO_RS18330,Saro_3491,94932,95723,sugar phosphate isomerase/epimerase,791
SARO_RS18335,Saro_3492,95720,96079,hypothetical protein,359
SARO_RS18340,Saro_3493,96177,101525,hybrid sensor histidine kinase/response regulator,5348
SARO_RS18345,Saro_3494,101599,103527,hybrid sensor histidine kinase/response regulator,1928
SARO_RS18350,Saro_3495,103570,103947,hypothetical protein,377
SARO_RS18355,Saro_3496,103944,104216,hypothetical protein,272
SARO_RS18360,Saro_3497,104216,104482,hypothetical protein,266
SARO_RS18365,Saro_3498,104486,105886,TolC family protein,1400
SARO_RS18370,Saro_3499,105883,106860,HlyD family secretion protein,977
SARO_RS18375,Saro_3500,106857,107075,DUF1656 domain-containing protein,218
SARO_RS18380,Saro_3501,107072,108991,FUSC family protein,1919
SARO_RS18385,Saro_3502,109145,110059,LysR family transcriptional regulator,914
SARO_RS18390,Saro_3503,110064,111347,methionine gamma-lyase,1283
SARO_RS18395,Saro_3504,111442,113673,copper-translocating P-type ATPase,2231
SARO_RS18400,Saro_3505,113750,115099,aromatic ring-hydroxylating dioxygenase subunit alpha,1349
SARO_RS18405,Saro_3506,115096,116250,hypothetical protein,1154
SARO_RS18410,Saro_3507,116247,117011,NAD(P)-dependent oxidoreductase,764
SARO_RS18415,Saro_3508,117083,119605,ligand-gated channel,2522
SARO_RS18420,Saro_3509,119701,120375,TetR/AcrR family transcriptional regulator,674
SARO_RS18425,Saro_3510,120424,121707,MFS transporter,1283
SARO_RS18430,Saro_3511,121779,122588,2-keto-4-pentenoate hydratase,809
SARO_RS18435,Saro_3512,122682,124205,altronate dehydratase,1523
SARO_RS18440,Saro_3513,124363,125379,LacI family DNA-binding transcriptional regulator,1016
SARO_RS18445,Saro_3514,125506,126144,hypothetical protein,638
SARO_RS18450,Saro_3515,126195,126962,2-deoxy-D-gluconate 3-dehydrogenase,767
SARO_RS18455,Saro_3516,126959,127969,sugar kinase,1010
SARO_RS18460,Saro_3517,127956,129500,carboxylesterase/lipase family protein,1544
SARO_RS18465,Saro_3518,129469,129891,cupin domain-containing protein,422
SARO_RS18470,Saro_3519,129888,131228,pectate lyase,1340
SARO_RS18475,Saro_3520,131472,134345,TonB-dependent receptor,2873
SARO_RS18480,Saro_3521,134441,135442,alpha/beta hydrolase,1001
SARO_RS18485,Saro_3522,135463,137049,xylan 1%2C4-beta-xylosidase,1586
SARO_RS18490,Saro_3523,137049,138449,glucuronate isomerase,1400
SARO_RS18495,Saro_3524,138446,139828,mannitol dehydrogenase family protein,1382
SARO_RS18500,Saro_3525,139952,142255,TonB-dependent receptor,2303
SARO_RS18505,Saro_3526,142258,143625,alkaline phosphatase family protein,1367
SARO_RS18510,Saro_3527,143693,144127,nuclear transport factor 2 family protein,434
SARO_RS18515,Saro_3528,144141,144827,KR domain-containing protein,686
SARO_RS18520,Saro_3529,144951,145625,TetR/AcrR family transcriptional regulator,674
SARO_RS18525,Saro_3530,145800,148157,TonB-dependent receptor,2357
SARO_RS18530,Saro_3531,148235,149311,nuclear transport factor 2 family protein,1076
SARO_RS18535,Saro_3532,149323,150084,KR domain-containing protein,761
SARO_RS18540,Saro_3533,150238,151434,cytochrome P450,1196
SARO_RS18545,Saro_3534,151523,152944,aromatic ring-hydroxylating dioxygenase subunit alpha,1421
SARO_RS18550,Saro_3535,152949,153467,nuclear transport factor 2 family protein,518
SARO_RS18555,Saro_3536,153493,154827,aromatic ring-hydroxylating dioxygenase subunit alpha,1334
SARO_RS18560,Saro_3537,154963,155514,VOC family protein,551
SARO_RS18565,Saro_3538,155598,156032,nuclear transport factor 2 family protein,434
SARO_RS18570,Saro_3539,156111,157457,aromatic ring-hydroxylating dioxygenase subunit alpha,1346
SARO_RS18575,Saro_3540,157498,159240,FAD-binding protein,1742
SARO_RS18580,Saro_3541,159237,159650,hypothetical protein,413
SARO_RS18585,Saro_3542,159623,160423,3-oxoacyl-ACP reductase,800
SARO_RS18590,Saro_3543,160464,161243,KR domain-containing protein,779
SARO_RS18595,Saro_3544,161388,162203,3-oxoacyl-ACP reductase,815
SARO_RS18600,Saro_3545,162209,162991,KR domain-containing protein,782
SARO_RS18605,Saro_3546,163147,164577,aromatic ring-hydroxylating dioxygenase subunit alpha,1430
SARO_RS18610,Saro_3547,164574,165362,hypothetical protein,788
SARO_RS18615,Saro_3548,165424,166593,acyl-CoA dehydrogenase,1169
SARO_RS18620,Saro_3549,166669,167436,helix-turn-helix transcriptional regulator,767
SARO_RS18625,Saro_3550,167458,167823,hypothetical protein,365
SARO_RS18630,Saro_3551,167825,168907,poly-beta-hydroxybutyrate polymerase,1082
SARO_RS18635,Saro_3552,168907,169485,N-acetyltransferase,578
SARO_RS18640,Saro_3553,169593,170372,permease,779
SARO_RS18645,Saro_3554,170377,171999,glucose-methanol-choline oxidoreductase,1622
SARO_RS18650,Saro_3555,172134,172532,DNA-binding protein,398
SARO_RS18655,Saro_3556,172529,173680,thiolase family protein,1151
SARO_RS18660,Saro_3557,173690,174904,acyl-CoA dehydrogenase,1214
SARO_RS18665,Saro_3558,174917,175891,thiamine pyrophosphate-dependent dehydrogenase E1 component subunit alpha,974
SARO_RS18670,Saro_3559,175909,176922,alpha-ketoacid dehydrogenase subunit beta,1013
SARO_RS18675,Saro_3560,176934,178376,2-oxo acid dehydrogenase subunit E2,1442
SARO_RS18680,Saro_3561,178373,178918,hypothetical protein,545
SARO_RS18685,Saro_3562,179047,181290,TonB-dependent receptor,2243
SARO_RS18690,NA,181743,183779,catalase HPII,2036
SARO_RS18695,Saro_3564,184205,184978,xylose isomerase,773
SARO_RS18700,Saro_3565,185016,186359,sugar (glycoside-Pentoside-hexuronide) transporter,1343
SARO_RS18705,Saro_3566,186371,187315,ThuA domain-containing protein,944
SARO_RS18710,Saro_3567,187337,187666,type II toxin-antitoxin system RelE/ParE family toxin,329
SARO_RS18715,Saro_3568,187679,187912,type II toxin-antitoxin system ParD family antitoxin,233
SARO_RS18720,Saro_3569,187953,189521,carboxylesterase,1568
SARO_RS18725,Saro_3570,189524,190378,nuclear transport factor 2 family protein,854
SARO_RS18730,Saro_3571,190655,191701,hypothetical protein,1046
SARO_RS18735,Saro_3572,191715,192089,hypothetical protein,374
SARO_RS18740,Saro_3573,192167,193030,DUF1080 domain-containing protein,863
SARO_RS18745,Saro_3574,193057,193467,aldehyde-activating protein,410
SARO_RS18750,Saro_3575,193498,194268,xylose isomerase,770
SARO_RS18755,Saro_3576,194272,195267,sugar phosphate isomerase/epimerase,995
SARO_RS18760,Saro_3577,195287,195670,hypothetical protein,383
SARO_RS18765,Saro_3578,195813,197438,FAD-binding protein,1625
SARO_RS18770,Saro_3579,197449,198057,TetR/AcrR family transcriptional regulator,608
SARO_RS18775,Saro_3580,198148,199557,carotenoid oxygenase,1409
SARO_RS18780,Saro_3581,199847,201334,thymidine phosphorylase,1487
SARO_RS18785,Saro_3582,201331,202227,phosphoribosylpyrophosphate synthetase,896
SARO_RS18790,Saro_3583,202232,202957,ABC transporter ATP-binding protein,725
SARO_RS18795,Saro_3584,202954,205317,ABC transporter permease,2363
SARO_RS18800,Saro_3585,205314,206483,efflux RND transporter periplasmic adaptor subunit,1169
SARO_RS18805,Saro_3586,206610,206885,metal/formaldehyde-sensitive transcriptional repressor,275
SARO_RS18810,Saro_3587,206897,207844,cation transporter,947
SARO_RS18815,Saro_3588,207982,208998,hypothetical protein,1016
SARO_RS18820,Saro_3589,209439,210644,plasmid replication initiator protein,1205
SARO_RS18825,Saro_3590,210877,211962,chromosome partitioning protein ParB,1085
SARO_RS18830,Saro_3591,212040,213242,chromosome partitioning protein,1202
SARO_RS18835,Saro_3592,213700,215745,methyl-accepting chemotaxis protein,2045
SARO_RS18840,Saro_3593,215751,217316,hypothetical protein,1565
SARO_RS18845,Saro_3594,217425,218588,flavin-dependent oxidoreductase,1163
SARO_RS18850,Saro_3595,218660,219805,helix-turn-helix transcriptional regulator,1145
SARO_RS18855,Saro_3596,219815,220201,steroid Delta-isomerase,386
SARO_RS20395,Saro_3597,220198,221010,sugar phosphate isomerase/epimerase,812
SARO_RS18865,Saro_3598,221144,222880,AMP-dependent synthetase,1736
SARO_RS18870,Saro_3599,222882,223748,amidohydrolase,866
SARO_RS18875,Saro_3600,223745,224608,KR domain-containing protein,863
SARO_RS18880,Saro_3601,224846,225853,(2Fe-2S)-binding protein,1007
SARO_RS18885,Saro_3602,225853,227358,amidase,1505
SARO_RS18890,Saro_3603,227398,228495,NADH:flavin oxidoreductase,1097
SARO_RS20400,Saro_3604,228533,229069,Lrp/AsnC family transcriptional regulator,536
SARO_RS20405,Saro_3605,229081,229572,Lrp/AsnC family transcriptional regulator,491
SARO_RS18905,Saro_3606,229640,230812,acyl-CoA dehydrogenase,1172
SARO_RS18910,Saro_3607,230820,231605,NAD(P)-dependent oxidoreductase,785
SARO_RS18915,Saro_3608,231720,232523,3-oxoacyl-ACP reductase,803
SARO_RS18920,Saro_3609,232528,233319,NAD(P)-dependent oxidoreductase,791
SARO_RS18925,Saro_3610,233334,234404,alkene reductase,1070
SARO_RS18930,Saro_3611,234410,235039,nuclear transport factor 2 family protein,629
SARO_RS18935,NA,235051,235626,flavin reductase,575
SARO_RS18940,Saro_3613,235899,236387,Lrp/AsnC family transcriptional regulator,488
SARO_RS18945,Saro_3614,236387,236941,Lrp/AsnC family transcriptional regulator,554
SARO_RS18950,Saro_3615,236938,237933,alpha/beta hydrolase domain-containing protein,995
SARO_RS18955,Saro_3616,237957,240092,FAD-binding protein,2135
SARO_RS18960,Saro_3617,240109,241701,AMP-dependent ligase,1592
SARO_RS20410,Saro_3618,241833,242228,glyoxalase/bleomycin resistance protein/dioxygenase,395
SARO_RS18970,Saro_3619,242308,243177,KR domain-containing protein,869
SARO_RS18980,Saro_3621,244009,245250,CoA transferase,1241
SARO_RS18985,Saro_3622,245247,246053,enoyl-CoA hydratase,806
SARO_RS18990,Saro_3623,246154,247053,LysR family transcriptional regulator,899
SARO_RS18995,Saro_3624,247139,248284,acyl-CoA dehydrogenase,1145
SARO_RS19000,Saro_3625,248302,249267,acyl-CoA dehydrogenase,965
SARO_RS19005,Saro_3626,249393,251078,FAD-binding protein,1685
SARO_RS19010,Saro_3627,251128,252951,DUF1446 domain-containing protein,1823
SARO_RS19015,Saro_3628,252956,253774,hypothetical protein,818
SARO_RS19020,Saro_3629,253867,256260,TonB-dependent receptor,2393
SARO_RS19025,Saro_3630,256434,257312,hypothetical protein,878
SARO_RS19030,Saro_3631,257419,259161,D-aminoacylase,1742
SARO_RS19035,Saro_3632,259375,260052,hypothetical protein,677
SARO_RS19040,Saro_3633,260204,260974,KR domain-containing protein,770
SARO_RS19045,NA,261021,261521,nuclear transport factor 2 family protein,500
SARO_RS19050,Saro_3635,261629,262207,GTP cyclohydrolase I FolE,578
SARO_RS19055,Saro_3636,262262,263560,MFS transporter,1298
SARO_RS19060,Saro_3637,263952,266528,TonB-dependent receptor,2576
SARO_RS19065,Saro_3638,266593,267342,NAD(P)-dependent oxidoreductase,749
SARO_RS19070,Saro_3639,267344,268465,gfo/Idh/MocA family oxidoreductase,1121
SARO_RS19075,Saro_3640,268462,269328,sugar phosphate isomerase/epimerase,866
SARO_RS19080,Saro_3641,269328,270560,DUF1214 domain-containing protein,1232
SARO_RS19085,Saro_3642,270562,271830,sulfotransferase,1268
SARO_RS19090,Saro_3643,271827,272870,alcohol dehydrogenase,1043
SARO_RS19095,Saro_3644,272988,273620,TetR/AcrR family transcriptional regulator,632
SARO_RS19100,Saro_3645,273719,274222,nuclear transport factor 2 family protein,503
SARO_RS19105,Saro_3646,274227,275996,D-aminoacylase,1769
SARO_RS19110,Saro_3647,276255,277175,biphenyl 2%2C3-dioxygenase,920
SARO_RS19115,Saro_3648,277208,278407,flavin-dependent monooxygenase,1199
SARO_RS19120,Saro_3649,278427,279515,(2Fe-2S)-binding protein,1088
SARO_RS19125,Saro_3650,279606,280364,short chain dehydrogenase,758
SARO_RS19130,Saro_3651,280481,282142,choline dehydrogenase,1661
SARO_RS19135,Saro_3652,282268,284238,GGDEF-domain containing protein,1970
SARO_RS19140,Saro_3653,284245,285171,chloramphenicol hydrolase,926
SARO_RS19145,Saro_3654,285193,286095,nucleoside-diphosphate sugar epimerase,902
SARO_RS19150,Saro_3655,286095,286904,NAD(P)-dependent oxidoreductase,809
SARO_RS19155,Saro_3656,286901,287332,nuclear transport factor 2 family protein,431
SARO_RS19160,Saro_3657,287329,288201,NAD(P)-dependent oxidoreductase,872
SARO_RS19165,Saro_3658,288333,288665,ferredoxin,332
SARO_RS19170,Saro_3659,288676,290097,cytochrome P450,1421
SARO_RS19175,Saro_3660,290253,291128,short-chain dehydrogenase,875
SARO_RS19180,NA,291143,292012,AraC family transcriptional regulator,869
SARO_RS19185,Saro_3662,292009,292767,hypothetical protein,758
SARO_RS19190,Saro_3663,292778,293539,KR domain-containing protein,761
SARO_RS19195,Saro_3664,293566,294732,sulfotransferase,1166
SARO_RS19200,Saro_3665,294831,295778,LysR family transcriptional regulator,947
SARO_RS19205,Saro_3666,295848,296927,(2Fe-2S)-binding protein,1079
SARO_RS19210,Saro_3667,297019,297798,3-oxoacyl-ACP reductase,779
SARO_RS19215,Saro_3668,297891,300164,TonB-dependent receptor,2273
SARO_RS19220,Saro_3669,300381,303047,glycoside hydrolase family 2,2666
SARO_RS19225,Saro_3670,303077,304312,MFS transporter,1235
SARO_RS19230,Saro_3671,304479,305000,hypothetical protein,521
SARO_RS19235,Saro_3672,305274,305600,excinuclease ABC subunit C,326
SARO_RS19240,Saro_3673,305749,306648,sugar kinase,899
SARO_RS19245,Saro_3674,306649,308169,hypothetical protein,1520
SARO_RS19250,Saro_3675,308174,309382,D-mannonate dehydratase,1208
SARO_RS19255,Saro_3676,309484,310236,FadR family transcriptional regulator,752
SARO_RS19260,Saro_3677,310264,311664,glucuronate isomerase,1400
SARO_RS19265,Saro_3678,311661,313043,mannitol dehydrogenase family protein,1382
SARO_RS19270,Saro_3679,313050,314153,alcohol dehydrogenase,1103
SARO_RS19275,Saro_3680,314150,315754,choline dehydrogenase,1604
SARO_RS20820,Saro_3681,315913,316125,ferredoxin,212
SARO_RS19280,Saro_3682,316122,317354,cytochrome P450,1232
SARO_RS19285,Saro_3683,317358,318047,hypothetical protein,689
SARO_RS19290,Saro_3684,318211,319044,xylose isomerase,833
SARO_RS19295,Saro_3685,319049,320011,aldo/keto reductase,962
SARO_RS19300,Saro_3686,320040,321494,flavoprotein,1454
SARO_RS19305,Saro_3687,321553,322593,4-hydroxy-2-oxovalerate aldolase,1040
SARO_RS19310,Saro_3688,322619,323554,acetaldehyde dehydrogenase,935
SARO_RS19315,Saro_3689,323567,324367,2-keto-4-pentenoate hydratase,800
SARO_RS19320,Saro_3690,324354,325187,3-oxoacyl-ACP reductase,833
SARO_RS19325,Saro_3691,325199,326410,acyl-CoA dehydrogenase type 2,1211
SARO_RS19330,NA,326566,327105,enoyl-CoA hydratase/isomerase,539
SARO_RS19335,Saro_3693,327164,328246,hypothetical protein,1082
SARO_RS20415,Saro_3694,328351,329019,TetR/AcrR family transcriptional regulator,668
SARO_RS19345,Saro_3695,329046,330368,FAD-binding oxidoreductase,1322
SARO_RS19350,Saro_3696,330391,331584,DUF1624 domain-containing protein,1193
SARO_RS19355,Saro_3697,331626,332018,RidA family protein,392
SARO_RS19360,Saro_3698,332018,333100,alanine racemase,1082
SARO_RS19365,Saro_3699,333303,334802,ABC transporter substrate-binding protein,1499
SARO_RS19370,Saro_3700,334883,336337,aldehyde dehydrogenase family protein,1454
SARO_RS19375,Saro_3701,336452,337366,LysR family transcriptional regulator,914
SARO_RS19380,NA,337750,338364,TetR/AcrR family transcriptional regulator,614
SARO_RS19385,Saro_3703,338430,340418,NAD(P)/FAD-dependent oxidoreductase,1988
SARO_RS19390,Saro_3704,340630,341742,acyl-CoA dehydrogenase,1112
SARO_RS19395,Saro_3705,341810,342298,Lrp/AsnC family transcriptional regulator,488
SARO_RS19400,Saro_3706,342298,342789,Lrp/AsnC family transcriptional regulator,491
SARO_RS19405,Saro_3707,343027,343830,KR domain-containing protein,803
SARO_RS19410,Saro_3708,343919,345403,NAD(P)/FAD-dependent oxidoreductase,1484
SARO_RS19415,Saro_3709,345425,346090,TetR/AcrR family transcriptional regulator,665
SARO_RS19420,Saro_3710,346176,347030,hypothetical protein,854
SARO_RS20420,Saro_3711,347150,348412,TetR family transcriptional regulator,1262
SARO_RS19430,Saro_3712,348419,349471,hypothetical protein,1052
SARO_RS19435,Saro_3713,349820,352384,TonB-dependent receptor,2564
SARO_RS19440,Saro_3714,352474,352935,nuclear transport factor 2 family protein,461
SARO_RS19445,Saro_3715,352951,353514,carboxymuconolactone decarboxylase family protein,563
SARO_RS19450,Saro_3716,353511,354311,NAD(P)-dependent oxidoreductase,800
SARO_RS19455,Saro_3717,354342,355091,KR domain-containing protein,749
SARO_RS19460,Saro_3718,355223,356014,NAD(P)-dependent oxidoreductase,791
SARO_RS19465,Saro_3719,356045,356722,3-ketoacyl-ACP reductase,677
SARO_RS20825,Saro_3720,356723,357547,ethyl tert-butyl ether degradation EthD,824
SARO_RS19480,Saro_3721,357544,359307,FAD binding domain-containing protein,1763
SARO_RS19485,Saro_3722,359419,359919,nuclear transport factor 2 family protein,500
SARO_RS19490,Saro_3723,359923,360936,alcohol dehydrogenase,1013
SARO_RS19495,Saro_3724,360941,362134,MFS transporter,1193
SARO_RS19500,Saro_3725,362222,364513,TonB-dependent receptor,2291
SARO_RS19505,Saro_3726,364860,365618,NAD(P)-dependent oxidoreductase,758
SARO_RS19510,Saro_3727,365637,366098,nuclear transport factor 2 family protein,461
SARO_RS19515,Saro_3728,366082,366903,hypothetical protein,821
SARO_RS19520,Saro_3729,366907,368070,sulfotransferase,1163
SARO_RS19525,Saro_3730,368198,368746,nuclear transport factor 2 family protein,548
SARO_RS19530,NA,368787,369770,oxidoreductase,983
SARO_RS19535,Saro_3732,369767,371473,FAD-binding protein,1706
SARO_RS19540,Saro_3733,371470,371928,nuclear transport factor 2 family protein,458
SARO_RS19545,Saro_3734,372023,372490,Lrp/AsnC family transcriptional regulator,467
SARO_RS19555,Saro_3736,373133,373912,KR domain-containing protein,779
SARO_RS19560,Saro_3737,373949,375022,DUF1214 domain-containing protein,1073
SARO_RS19565,Saro_3738,375037,375798,NAD(P)-dependent oxidoreductase,761
SARO_RS19570,Saro_3739,375795,377006,MFS transporter,1211
SARO_RS19575,Saro_3740,377003,379138,FAD-dependent oxidoreductase,2135
SARO_RS19580,Saro_3741,379356,380303,thiamine pyrophosphate-dependent dehydrogenase E1 component subunit alpha,947
SARO_RS19585,Saro_3742,380293,381276,TPP-dependent acetoin dehydrogenase complex%2C E1 protein subunit beta,983
SARO_RS19590,Saro_3743,381288,382508,2-oxo acid dehydrogenase subunit E2,1220
SARO_RS19595,Saro_3744,382668,384929,TonB-dependent receptor,2261
SARO_RS19600,Saro_3745,385008,385571,nuclear transport factor 2 family protein,563
SARO_RS19605,Saro_3746,385549,386007,SRPBCC domain-containing protein,458
SARO_RS19610,Saro_3747,386091,386861,KR domain-containing protein,770
SARO_RS19615,Saro_3748,386938,388149,acyl-CoA dehydrogenase type 2,1211
SARO_RS19620,Saro_3749,388348,389112,short chain dehydrogenase,764
SARO_RS19625,Saro_3750,389118,390041,glyoxalase,923
SARO_RS19630,Saro_3751,390059,390934,CoA transferase subunit A,875
SARO_RS19635,Saro_3752,390934,391725,acyl CoA--acetate/3-ketoacid CoA transferase subunit beta,791
SARO_RS19640,Saro_3753,391738,392637,enoyl-CoA hydratase,899
SARO_RS19645,Saro_3754,392637,393701,nitronate monooxygenase,1064
SARO_RS19650,Saro_3755,393725,394480,enoyl-CoA hydratase,755
SARO_RS19655,Saro_3756,394497,395642,acyl-CoA dehydrogenase,1145
SARO_RS19660,Saro_3757,395657,396688,acyl-CoA dehydrogenase,1031
SARO_RS19665,Saro_3758,396681,397832,acetyl-CoA C-acyltransferase,1151
SARO_RS19670,Saro_3759,397838,398278,nuclear transport factor 2 family protein,440
SARO_RS19675,Saro_3760,398301,399206,KR domain-containing protein,905
SARO_RS19680,Saro_3761,399234,400289,acyl-CoA dehydrogenase,1055
SARO_RS19685,Saro_3762,400286,401464,acyl-CoA dehydrogenase,1178
SARO_RS19690,Saro_3763,401490,402275,short chain dehydrogenase,785
SARO_RS19695,Saro_3764,402279,402737,MaoC family dehydratase,458
SARO_RS19700,Saro_3765,402743,403120,nuclear transport factor 2,377
SARO_RS19705,Saro_3766,403133,404335,acetyl-CoA C-acyltransferase,1202
SARO_RS19710,Saro_3767,404342,405880,fatty acid--CoA ligase,1538
SARO_RS19715,Saro_3768,405900,406670,NAD(P)-dependent oxidoreductase,770
SARO_RS19720,Saro_3769,406935,407681,3'(2')%2C5'-bisphosphate nucleotidase CysQ,746
SARO_RS19725,Saro_3770,407736,408845,regulatory protein%2C LuxR,1109
SARO_RS19730,Saro_3771,409016,411400,TonB-dependent receptor,2384
SARO_RS19735,Saro_3772,411448,412188,NAD(P)-dependent oxidoreductase,740
SARO_RS19740,Saro_3773,412206,413291,DUF1214 domain-containing protein,1085
SARO_RS19745,Saro_3774,413328,414146,dioxygenase,818
SARO_RS19750,Saro_3775,414152,415393,glycerate kinase,1241
SARO_RS19755,Saro_3776,415463,416236,NAD(P)-dependent oxidoreductase,773
SARO_RS19760,Saro_3777,416325,417224,DUF2236 domain-containing protein,899
SARO_RS19765,Saro_3778,417242,419710,TonB-dependent receptor,2468
SARO_RS19770,Saro_3779,419850,420596,LuxR family transcriptional regulator,746
SARO_RS19775,Saro_3780,420652,421776,acyl-CoA dehydrogenase,1124
SARO_RS20425,Saro_3781,421803,423146,EAL domain-containing protein,1343
SARO_RS19785,Saro_3782,423143,423475,response regulator,332
SARO_RS19790,Saro_3783,423472,425598,Cache sensor signal transduction histidine kinase,2126
SARO_RS20430,Saro_3784,425714,427204,sensor histidine kinase,1490
SARO_RS19800,Saro_3785,427226,429472,TonB-dependent receptor,2246
SARO_RS19805,Saro_3786,429582,430556,acyl-CoA dehydrogenase,974
SARO_RS19810,Saro_3787,430677,432065,TolC family protein,1388
SARO_RS19815,Saro_3788,432065,433180,RND transporter,1115
SARO_RS19820,Saro_3789,433184,434911,ABC transporter ATP-binding protein,1727
SARO_RS19825,Saro_3790,435196,436728,phosphomannomutase,1532
SARO_RS19830,Saro_3791,436808,437674,bifunctional methylenetetrahydrofolate dehydrogenase/methenyltetrahydrofolate cyclohydrolase,866
SARO_RS19835,Saro_3792,437671,439200,EmrB/QacA family drug resistance transporter,1529
SARO_RS19840,Saro_3793,439187,440257,HlyD family secretion protein,1070
SARO_RS19845,Saro_3794,440250,440699,MarR family transcriptional regulator,449
SARO_RS19850,Saro_3795,440751,442337,acyl-CoA dehydrogenase,1586
SARO_RS19855,Saro_3796,442337,443194,hypothetical protein,857
SARO_RS19860,Saro_3797,443505,445259,SARP family transcriptional regulator,1754
SARO_RS19865,Saro_3798,445320,449651,cytochrome P450-like protein,4331
SARO_RS19870,Saro_3799,449699,450388,RES domain-containing protein,689
SARO_RS19875,Saro_3800,450392,450775,DUF2384 domain-containing protein,383
SARO_RS19880,Saro_3801,450937,451479,regulatory protein%2C LuxR,542
SARO_RS19885,Saro_3802,451544,457795,outer membrane autotransporter,6251
SARO_RS19890,Saro_3803,458179,459345,integrase,1166
SARO_RS19895,Saro_3804,459336,461468,integrase,2132
SARO_RS19900,Saro_3805,461465,461944,hypothetical protein,479
SARO_RS19905,Saro_3806,462183,462698,flavin reductase domain-containing protein,515
SARO_RS19910,Saro_3807,462670,463410,KR domain-containing protein,740
SARO_RS19915,Saro_3808,463407,463772,hypothetical protein,365
SARO_RS19920,Saro_3809,463791,464954,acyl-CoA dehydrogenase,1163
SARO_RS19925,Saro_3810,465204,465764,nuclear transport factor 2 family protein,560
SARO_RS19930,Saro_3811,465785,467293,aldehyde dehydrogenase,1508
SARO_RS19935,Saro_3812,467518,468504,AraC family transcriptional regulator,986
SARO_RS19940,Saro_3813,468548,469045,hypothetical protein,497
SARO_RS19945,Saro_3814,469042,470334,Rieske (2Fe-2S) protein,1292
SARO_RS19950,Saro_3815,470336,471562,amidase,1226
SARO_RS19955,Saro_3816,471857,474226,TonB-dependent receptor,2369
SARO_RS19960,Saro_3817,474241,474606,cytochrome c,365
SARO_RS19965,Saro_3818,474640,475857,methylamine dehydrogenase heavy subunit,1217
SARO_RS19970,Saro_3819,475854,476396,hypothetical protein,542
SARO_RS19975,Saro_3820,476393,477001,methylamine dehydrogenase accessory protein MauD,608
SARO_RS19980,Saro_3821,477038,477559,methylamine dehydrogenase light chain,521
SARO_RS19985,NA,477565,478050,hypothetical protein,485
SARO_RS19990,Saro_3823,478201,478929,CoA transferase subunit A,728
SARO_RS19995,Saro_3824,478926,479564,CoA transferase subunit B,638
SARO_RS20000,Saro_3825,479561,480763,3-oxoadipyl-CoA thiolase,1202
SARO_RS20005,Saro_3826,480766,481563,3-oxoadipate enol-lactonase,797
SARO_RS20010,Saro_3827,481560,482474,LysR family transcriptional regulator,914
SARO_RS20015,Saro_3828,482563,483726,muconate cycloisomerase,1163
SARO_RS20020,Saro_3829,483730,484020,muconolactone delta-isomerase,290
SARO_RS20025,Saro_3830,484047,484943,3'-RNA processing protein,896
SARO_RS20030,Saro_3831,484991,486013,LacI family DNA-binding transcriptional regulator,1022
SARO_RS20035,Saro_3832,486063,487253,cytochrome P450,1190
